Model No.,Godwan,MT Stock,IB Stock,DDN Stock,DL Stock,CHD Stock,Main,Sample Line,Total
GW0265G10,0,0,0,1,0,0,0,0,1
GW0509L1,0,1,1,1,1,0,2,1,7
GW0550L3,0,0,0,0,1,0,0,0,1
GW0573G3,0,1,1,2,1,0,0,0,5
GW0574G3,0,1,1,1,1,0,2,1,7
GW0389G2,0,0,0,0,0,0,0,0,0
GW0494G3,0,0,0,0,0,0,0,0,0
GW0572G2,0,0,1,1,0,0,0,1,3
GW0605L3,0,0,0,1,1,0,0,0,2
GW0616L2,0,1,1,1,2,0,1,1,7
GW0626G3,0,1,1,1,1,0,2,1,7
GW0619L2,0,0,0,0,0,0,0,0,0
GW0627G2,0,1,1,1,1,0,0,1,5
GW0604L3,0,0,0,1,1,0,0,1,3
GW0639G2,0,1,1,1,1,0,0,0,4
GW0639G3,0,1,1,1,1,0,5,1,10
GW0641G2,0,0,0,1,0,0,0,0,1
GW0616L3,0,1,1,1,1,0,12,1,17
GW0655L2,0,0,0,0,1,0,0,0,1
GW0657L3,0,1,1,1,1,0,9,1,14
GW0575G3,0,1,1,1,1,0,3,1,8
GW0493G3,0,0,0,0,0,0,0,0,0
GW0657L2,0,1,1,1,1,0,3,1,8
GW0658L1,0,0,0,0,0,0,0,1,1
GW0661G3,0,1,1,1,1,0,11,1,16
GW0658L2,0,0,0,0,0,0,0,0,0
GW0658L3,0,0,0,1,2,0,0,0,3
GW0661G2,0,0,0,0,2,0,0,0,2
GW0663G2,0,0,0,0,1,0,0,0,1
GW0653L2,0,0,0,1,0,0,0,0,1
GW0665L2,0,1,0,1,1,0,0,0,3
GW0665L1,0,1,0,1,0,0,0,0,2
GW0668L2,0,0,0,1,1,0,0,1,3
GW0663G3,0,1,1,1,1,0,9,1,14
GW0675L2,0,0,0,1,1,0,0,0,2
GW0675L3,0,1,1,1,1,0,15,1,20
GW0671L3,0,1,0,0,1,0,0,0,2
GW0685L3,0,1,1,1,1,0,7,1,12
GW0686L3,0,1,1,1,1,0,6,1,11
GW0668L3,0,0,0,0,0,0,0,1,1
GW0687L3,0,1,1,1,1,0,7,1,12
GW0686L2,0,0,0,0,0,0,0,0,0
GW0694L4,0,1,1,1,1,0,4,1,9
GW0696L3,0,1,0,0,1,0,0,0,2
GW0703G4,0,0,0,0,0,0,0,0,0
GW0627G3,0,1,1,1,1,0,1,1,6
GW0655L3,0,0,0,0,0,0,0,0,0
GW0707G3,0,1,1,1,1,0,0,0,4
GW0709G2,0,1,0,0,0,0,0,0,1
GW0703G3,0,0,1,1,1,0,0,2,5
GW0708G3,0,1,1,1,1,0,6,1,11
GW0713G2,0,0,0,1,1,0,0,0,2
GW0710G3,0,1,0,0,1,0,0,0,2
GW0714G1,0,1,1,2,1,0,1,1,7
GW0714G3,0,1,1,1,1,0,15,1,20
GW0714G2,0,0,0,1,1,0,0,0,2
GW0714G4,0,1,1,2,1,0,9,1,15
GW0718G1,0,1,1,2,1,0,0,1,6
GW0723L1,0,0,0,1,1,0,0,1,3
GW0725L2,0,1,1,1,1,0,8,1,13
GW0723L2,0,0,1,1,1,0,0,1,4
GW0718G2,0,1,1,2,1,0,1,1,7
GW0725L1,0,0,1,1,1,0,0,1,4
GW0728G1,0,1,1,1,1,0,0,0,4
GW0728G2,0,1,0,1,1,0,0,0,3
GW0727G1,0,0,0,1,0,0,0,0,1
GW0729G1,0,1,0,1,1,0,0,0,3
W1161G1,0,0,0,1,1,0,0,0,2
GW0729G2,0,1,1,1,0,0,0,1,4
GW0478L2,0,0,0,0,1,0,0,0,1
GW0216G2,0,0,0,0,0,0,0,0,0
W1070L3,0,0,0,0,0,0,0,1,1
GW0263G4,0,0,0,0,0,0,0,0,0
GW0729G3,0,1,1,1,1,0,6,1,11
GW0703G2,0,0,0,0,0,0,0,0,0
GW0388G3,0,0,0,0,0,0,0,0,0
GW0708G2,0,1,1,2,0,0,6,1,11
GW0413L2,0,0,0,0,0,0,0,0,0
GW0030L2,0,0,0,0,1,0,0,0,1
GW0022L2,0,0,0,1,1,0,0,0,2
GW0022L3,0,1,1,1,1,0,0,1,5
GW0707G1,0,1,0,1,1,0,0,1,4
GW0202G4,0,1,1,1,2,0,3,1,9
GW0202G1,0,1,1,1,1,0,0,1,5
GW0202G5,0,0,0,0,0,0,0,0,0
GW0203G9,0,0,0,0,0,0,0,0,0
GW0203G10,0,0,0,0,0,0,0,0,0
GW0265G7,0,0,0,1,0,0,0,0,1
GW0308L5,0,0,0,0,0,0,0,1,1
GW0359L1,0,0,0,0,0,0,0,0,0
GW0354L3,0,0,0,0,0,0,0,0,0
GW0260G4,0,0,0,1,1,0,0,0,2
GW0401L3,0,1,1,1,2,0,1,1,7
GW0404L2,0,1,1,1,1,0,0,0,4
GW0404L1,0,0,0,0,0,0,0,0,0
GW0320L2,0,1,1,1,0,0,0,0,3
GW0404L3,0,1,1,1,1,0,11,1,16
GW0456G2,0,1,1,1,2,0,0,1,6
GW0401L1,0,0,0,0,0,0,0,0,0
GW0470L3,0,1,0,1,2,0,0,1,5
GW0468L2,0,1,0,1,1,0,0,0,3
GW0452L1,0,0,0,0,1,0,0,0,1
GW0470L1,0,0,0,0,0,0,0,0,0
GW0468L4,0,0,0,1,1,0,0,0,2
GW0476L2,0,0,0,0,0,0,0,0,0
GW0500G2,0,0,0,1,0,0,0,0,1
GW0502G2,0,1,1,1,1,0,0,1,5
GW0456G3,0,0,0,1,1,0,0,1,3
GW0474L2,0,0,0,0,0,0,0,0,0
GW0471L3,0,0,0,0,1,0,0,0,1
GW0503G1,0,0,1,1,1,0,0,1,4
GW0503G2,0,1,1,1,1,0,1,1,6
GW0503G3,0,1,1,1,1,0,0,1,5
GW0686L4,0,1,0,1,1,0,0,0,3
GW0474L3,0,0,1,1,0,0,0,1,3
GW0502G1,0,0,0,1,0,0,0,0,1
GW0485L1,0,1,1,1,1,0,3,1,8
GW0487G1,0,0,0,1,1,0,0,0,2
GW0508L3,0,0,0,1,2,0,0,1,4
GW0485L2,0,1,1,1,1,0,2,1,7
GW0528L4,0,0,0,0,0,0,0,0,0
GW0530L3,0,1,0,0,1,0,0,0,2
GW0491G3,0,0,0,0,0,0,0,0,0
GW0532L5,0,1,1,0,1,0,0,0,3
GW0534L3,0,1,0,1,1,0,0,0,3
GW0490G2,0,0,0,0,0,0,0,0,0
GW0471L2,0,0,0,1,0,0,0,0,1
GW0539G1,0,1,1,0,1,0,0,1,4
GW0545L2,0,0,0,0,0,0,0,0,0
GW0536L2,0,0,0,0,0,0,0,0,0
GW0552L4,0,0,0,0,0,0,0,0,0
GW0549L3,0,0,0,0,0,0,0,0,0
GW0555L4,0,1,0,1,1,0,0,1,4
GW0534L2,0,0,0,0,0,0,0,0,0
GW0558L2,0,1,1,1,0,0,0,0,3
GW0504L5,0,0,0,0,0,0,0,0,0
GW0552L2,0,0,0,0,0,0,0,0,0
GW0574G1,0,0,0,0,0,0,1,0,1
GW0562L3,0,1,0,0,1,0,0,0,2
GW0569G3,0,0,0,1,1,0,0,0,2
GW0571G2,0,1,1,1,1,0,3,1,8
GW0591L1,0,0,0,1,1,0,0,0,2
GW0265G8,0,0,0,1,0,0,1,1,3
GW0574G2,0,0,0,1,1,0,0,0,2
W0799G2,0,0,0,0,2,0,0,1,3
GW0479L1,0,0,0,0,1,0,0,0,1
GW0713G1,0,0,0,0,1,0,0,0,1
GW0410L4,0,0,0,0,0,0,0,0,0
GW0529L4,0,0,0,0,0,0,0,0,0
GW0420G3,0,0,0,0,0,0,0,0,0
GW0465L2,0,0,0,0,0,0,0,0,0
GW0033L1,0,0,0,0,0,0,0,0,0
GW0552L3,0,0,0,0,0,0,0,0,0
GW0420G2,0,0,0,0,1,0,0,0,1
GW0033L2,0,0,0,0,0,0,0,0,0
GW0265G9,0,0,0,0,0,0,0,0,0
GW0326G1,0,0,0,0,0,0,0,0,0
GW0382L1,0,0,0,0,0,0,0,0,0
GW0359L3,0,0,0,0,0,0,0,0,0
GW0385L3,0,1,0,0,0,0,0,0,1
GW0382L3,0,0,0,0,0,0,0,0,0
GW0118L4,0,0,0,0,0,0,0,0,0
GW0386G3,0,0,0,0,0,0,0,0,0
GW0387G3,0,0,0,0,0,0,0,0,0
GW0368G3,0,0,0,0,0,0,0,0,0
GW0109L1,0,0,0,0,0,0,0,0,0
GW0403L3,0,0,0,0,0,0,0,0,0
GW0099L3,0,0,0,0,0,0,0,0,0
GW0403L2,0,0,0,0,0,0,0,0,0
GW0411L1,0,0,0,0,0,0,0,0,0
GW0248G2,0,0,0,0,0,0,0,0,0
GW0203G4,0,0,0,0,0,0,0,0,0
GW0423G4,0,0,0,0,0,0,0,0,0
GW0250G1,0,0,0,0,0,0,0,0,0
GW0451L2,0,0,0,0,0,0,0,0,0
GW0428G1,0,0,0,0,0,0,0,0,0
GW0451L1,0,0,0,0,0,0,0,0,0
GW0104L3,0,0,0,0,0,0,0,0,0
GW0480L1,0,0,0,0,0,0,0,0,0
GW0454G3,0,0,0,0,0,0,0,0,0
GW0631G2,0,0,0,1,0,0,0,0,1
GW0494G2,0,0,0,0,0,0,0,0,0
GW0492G2,0,0,0,0,0,0,0,0,0
GW0484L1,0,0,0,0,0,0,0,0,0
GW0454G2,0,0,0,0,0,0,0,0,0
W1262G4,0,0,0,0,0,0,0,0,0
GW0760L1,0,1,1,1,1,0,0,1,5
GW0555L2,0,0,0,0,1,0,0,1,2
GW0579G3,0,0,0,0,0,0,0,0,0
GW0572G6,0,0,0,1,0,0,0,0,1
GW0482L2,0,0,0,0,0,0,0,0,0
GW0745L4,0,1,1,1,1,0,1,1,6
GW0748L2,0,1,1,1,1,0,0,1,5
GW0530L6,0,0,0,0,0,0,0,0,0
GW0220G4,0,0,0,0,0,0,0,0,0
GW0760L2,0,1,1,1,1,0,7,1,12
GW0300L2,0,0,0,0,0,0,0,0,0
GW0401L2,0,0,0,1,1,0,0,0,2
GW0456G5,0,0,0,0,0,0,0,1,1
GW0464L3,0,0,1,1,0,0,0,1,3
GW0456G1,0,1,1,1,1,0,7,1,12
GW0464L5,0,1,1,1,1,0,0,1,5
GW0464L2,0,1,1,1,1,0,0,1,5
GW0033L8,0,0,0,0,1,0,0,1,2
GW0470L2,0,1,1,1,1,0,0,0,4
GW0468L3,0,0,0,1,0,0,0,0,1
GW0497G2,0,0,0,0,0,0,0,0,0
GW0476L3,0,0,0,0,0,0,0,0,0
GW0487G5,0,0,0,0,0,0,0,0,0
GW0438L2,0,0,0,0,0,0,0,0,0
GW0499G2,0,0,0,0,0,0,0,0,0
GW0499G1,0,0,0,0,0,0,0,0,0
GW0438L3,0,0,0,0,0,0,0,0,0
GW0503G4,0,0,0,1,1,0,0,0,2
GW0508L2,0,0,1,1,2,0,0,1,5
GW0535L3,0,0,0,0,0,0,0,0,0
GW0438L6,0,0,0,0,0,0,0,0,0
GW0528L1,0,0,0,0,0,0,0,0,0
GW0558L3,0,1,1,1,0,0,0,1,4
GW0539G2,0,1,1,1,2,0,0,1,6
GW0550L1,0,0,0,0,0,0,0,0,0
GW0500G1,0,1,1,1,0,0,0,0,3
GW0571G4,0,1,1,1,1,0,0,1,5
GW0572G4,0,1,1,1,0,0,0,1,4
GW0530L4,0,0,0,0,0,0,0,0,0
GW0539G3,0,0,1,1,2,0,0,0,4
GW0569G2,0,0,0,0,1,0,0,0,1
GW0573G2,0,0,0,1,1,0,0,1,3
GW0572G5,0,1,1,1,1,0,6,1,11
GW0575G4,0,1,1,2,0,0,0,0,4
GW0575G2,0,0,0,1,1,0,0,0,2
GW0582G3,0,1,1,1,1,0,0,1,5
GW0571G3,0,1,1,1,2,0,0,1,6
GW0573G1,0,0,1,0,1,0,0,0,2
GW0582G2,0,1,0,1,1,0,0,0,3
GW0583G2,0,0,0,1,0,0,0,0,1
GW0600L2,0,0,0,0,0,0,0,0,0
GW0604L2,0,1,0,0,1,0,0,0,2
GW0577G2,0,1,0,1,1,0,0,0,3
GW0575G1,0,0,0,1,1,0,0,1,3
GW0613L3,0,1,1,1,1,0,2,1,7
GW0604L4,0,0,0,0,1,0,0,0,1
GW0614L2,0,0,0,0,0,0,0,0,0
GW0615L3,0,0,0,0,0,0,0,0,0
GW0620L2,0,0,0,0,0,0,0,0,0
GW0621L5,0,0,0,0,1,0,0,0,1
GW0607L3,0,1,2,1,1,0,2,1,8
GW0626G4,0,1,1,1,0,0,0,0,3
GW0624G2,0,1,0,1,1,0,0,0,3
GW0606L2,0,1,1,1,1,0,0,0,4
GW0627G1,0,1,0,1,1,0,0,0,3
GW0637G2,0,0,0,0,1,0,0,0,1
GW0629G3,0,0,0,0,0,0,0,0,0
GW0628G4,0,1,1,1,1,0,3,1,8
GW0645G2,0,0,0,0,1,0,0,0,1
GW0631G3,0,0,0,1,3,0,0,1,5
GW0631G1,0,0,1,1,0,0,3,1,6
GW0626G2,0,1,1,1,1,0,2,1,7
GW0640G2,0,0,0,0,0,0,0,0,0
GW0640G3,0,1,0,1,0,0,0,1,3
GW0640G1,0,0,0,1,1,0,0,0,2
GW0629G1,0,0,0,0,0,0,0,0,0
GW0645G4,0,1,1,1,1,0,0,0,4
GW0653L1,0,0,0,1,1,0,0,0,2
W0911L3,0,0,0,1,0,0,0,0,1
GW0620L4,0,0,0,1,1,0,0,0,2
W0443L4,0,0,0,0,0,0,0,0,0
W0911L6,0,0,0,1,1,0,0,0,2
GW0314L1,0,0,0,0,0,0,0,0,0
GW0302L3,0,0,0,0,1,0,0,0,1
GW0399L3,0,0,0,0,0,0,0,0,0
GW0483L3,0,0,0,0,0,0,0,0,0
GW0322G1,0,0,0,1,0,0,0,1,2
GW0493G2,0,0,0,0,0,0,0,0,0
GW0219G1,0,0,0,0,0,0,0,0,0
GW0699L2,0,1,0,0,1,0,0,0,2
GW0529L1,0,0,0,0,0,0,0,0,0
GW0557L2,0,1,0,0,1,0,0,0,2
GW0528L2,0,0,0,0,1,0,0,0,1
GW0547L3,0,1,0,0,0,0,0,0,1
GW0308L3,0,0,0,0,1,0,0,0,1
GW0033L3,0,0,0,0,0,0,0,0,0
GW0049G1,0,0,0,0,0,0,0,0,0
GW0488G1,0,0,0,0,0,0,0,0,0
GW0102L3,0,0,0,0,0,0,0,0,0
GW0057G2,0,0,0,0,0,0,0,0,0
GW0034L4,0,0,0,0,0,0,0,0,0
GW0262G3,0,0,0,0,0,0,0,0,0
GW0207G2,0,0,0,0,0,0,0,0,0
GW0257L1,0,0,0,0,0,0,0,0,0
GW0257L2,0,0,0,0,0,0,0,0,0
GW0207G1,0,0,0,0,0,0,0,0,0
GW0264G3,0,0,0,0,0,0,0,0,0
GW0300L1,0,0,0,0,0,0,0,0,0
GW0265G1,0,0,0,0,0,0,0,0,0
GW0256L1,0,0,0,0,0,0,0,0,0
GW0477L3,0,0,0,0,0,0,0,0,0
GW0314L3,0,0,0,0,0,0,0,0,0
GW0308L2,0,0,0,0,0,0,0,0,0
GW0324G2,0,0,0,0,0,0,0,0,0
GW0312L3,0,0,0,0,0,0,0,0,0
GW0312L2,0,0,0,0,0,0,0,0,0
GW0030L3,0,0,0,0,0,0,0,0,0
GW0329G1,0,0,0,0,0,0,0,0,0
GW0353G2,0,0,0,0,0,0,0,0,0
GW0358L1,0,0,0,0,0,0,0,0,0
GW0355L1,0,0,0,0,0,0,0,0,0
GW0332G1,0,0,0,0,0,0,0,0,0
GW0368G2,0,0,0,0,0,0,0,0,0
GW0314L2,0,0,0,0,0,0,0,0,0
GW0359L2,0,0,0,0,0,0,0,0,0
GW0387G2,0,0,0,0,0,0,0,0,0
GW0328G1,0,0,0,0,0,0,0,0,0
GW0402L3,0,0,0,0,0,0,0,0,0
GW0421G1,0,0,0,0,0,0,0,0,0
GW0405L3,0,0,0,0,0,0,0,0,0
GW0465L1,0,0,0,0,0,0,0,0,0
GW0464L4,0,0,0,0,0,0,0,0,0
GW0488G3,0,0,0,0,0,0,0,0,0
GW0487G4,0,0,0,0,0,0,0,0,0
GW0357L1,0,0,0,0,0,0,0,0,0
GW0536L4,0,0,0,0,0,0,0,0,0
GW0495G2,0,0,0,0,0,0,0,0,0
GW0587L3,0,0,0,0,0,0,0,0,0
GW0248G3,0,0,0,0,0,0,0,0,0
GW0308L6,0,1,1,1,1,0,10,1,15
GW0589L1,0,0,0,0,0,0,0,0,0
GW0566G2,0,0,0,0,0,0,0,0,0
GW0617L3,0,1,1,1,1,0,5,1,10
GW0753L4,0,1,0,1,1,0,0,1,4
GW0538G1,0,0,0,0,0,0,0,0,0
GW0531L1,0,0,0,0,0,0,0,0,0
GW0492G3,0,0,0,0,0,0,0,0,0
GW0495G4,0,0,0,0,0,0,0,0,0
GW0490G3,0,0,0,0,0,0,0,0,0
GW0542G1,0,0,0,0,0,0,0,0,0
GW0549L2,0,0,0,0,0,0,0,0,0
GW0753L3,0,1,1,1,1,0,1,1,6
GW0489G2,0,0,0,0,0,0,0,0,0
GW0553L4,0,0,0,0,0,0,0,0,0
GW0428G3,0,0,0,0,0,0,0,0,0
GW0759L2,0,0,0,0,1,0,0,1,2
GW0554L5,0,0,0,0,0,0,0,0,0
GW0555L3,0,0,0,0,0,0,0,0,0
GW0583G3,0,0,0,0,0,0,0,0,0
GW0581G2,0,0,0,0,0,0,0,0,0
GW0568G1,0,0,0,0,0,0,0,0,0
GW0531L2,0,0,0,0,0,0,0,0,0
GW0543L2,0,0,0,0,0,0,0,0,0
GW0579G1,0,0,0,0,0,0,0,0,0
GW0587L2,0,0,0,0,0,0,0,0,0
GW0542G2,0,0,0,0,0,0,0,0,0
GW0565G2,0,0,0,0,0,0,0,0,0
GW0548L3,0,0,0,0,0,0,0,0,0
GW0423G3,0,0,0,0,0,0,0,0,0
GW0557L1,0,0,0,0,0,0,0,0,0
GW0413L3,0,0,0,0,0,0,0,0,0
GW0490G5,0,0,0,0,0,0,0,0,0
GW0410L2,0,0,0,0,0,0,0,0,0
GW0538G3,0,0,0,0,0,0,0,0,0
GW0544L2,0,0,0,0,0,0,0,0,0
GW0544L4,0,0,0,0,0,0,0,0,0
GW0300L3,0,1,1,1,1,0,0,0,4
GW0571G5,0,1,1,1,1,0,1,1,6
GW0499G6,0,0,0,0,0,0,0,0,0
GW0202G2,0,1,1,2,1,0,0,0,5
GW0536L5,0,0,0,0,0,0,0,0,0
GW0535L4,0,1,0,1,1,0,0,0,3
GW0620L3,0,1,1,1,1,0,0,1,5
GW0613L2,0,0,0,1,1,0,0,0,2
GW0544L1,0,0,0,0,0,0,0,0,0
GW0491G4,0,0,1,1,0,0,0,1,3
GW0486G2,0,0,0,0,0,0,0,0,0
GW0495G3,0,0,0,0,0,0,0,0,0
W1307G2,0,0,0,0,0,0,0,0,0
GW0032L3,0,0,0,0,0,0,0,0,0
GW0566G1,0,0,0,0,0,0,0,0,0
W1227L3,0,0,0,0,0,0,0,0,0
W1156L3,0,0,0,1,0,0,0,0,1
W1107G3,0,0,0,0,0,0,0,0,0
GW0753L5,0,1,1,1,1,0,0,1,5
GW0538G2,0,0,0,0,0,0,0,0,0
W1288L3,0,0,0,0,0,0,0,0,0
GW0762L1,0,0,0,1,0,0,0,1,2
GW0588L1,0,0,0,0,1,0,0,0,1
GW0760L3,0,1,1,1,1,0,12,1,17
GW0426G3,0,0,0,0,0,0,0,0,0
W1053L1,0,0,0,0,0,0,0,0,0
W0638L4,0,0,0,0,0,0,0,0,0
W1142L4,0,0,0,0,0,0,0,0,0
GW0466L2,0,0,0,0,0,0,0,0,0
GW0556L2,0,0,0,0,0,0,0,0,0
GW0411L2,0,0,0,0,0,0,0,0,0
GW0454G1,0,0,0,0,0,0,0,0,0
GW0426G2,0,0,0,0,0,0,0,0,0
GW0492G1,0,0,0,0,0,0,0,0,0
GW0466L1,0,0,0,0,0,0,0,0,0
GW0483L2,0,0,0,0,0,0,0,0,0
GW0488G2,0,1,0,0,0,0,0,0,1
GW0472L2,0,0,0,0,0,0,0,0,0
GW0488G4,0,0,0,0,0,0,0,0,0
GW0482L1,0,0,0,0,0,0,0,0,0
GW0439L2,0,0,0,0,0,0,0,0,0
GW0327G2,0,0,0,0,0,0,0,0,0
GW0547L2,0,0,0,0,1,0,0,0,1
W1288L2,0,0,0,0,1,0,0,0,1
GW0307L3,0,0,0,0,0,0,0,0,0
GW0057G1,0,0,0,0,0,0,0,0,0
GW0284L1,0,0,0,0,0,0,0,0,0
GW0550L2,0,0,0,1,0,0,0,0,1
GW0220G1,0,0,0,0,0,0,0,0,0
GW0203G5,0,0,0,0,0,0,0,0,0
GW0570G2,0,0,0,0,0,0,0,0,0
GW0263G1,0,0,0,0,0,0,0,0,0
GW0572G3,0,1,1,1,1,0,17,1,22
GW0203G6,0,0,0,0,0,0,0,0,0
GW0570G1,0,0,0,0,0,0,0,0,0
GW0315L1,0,0,0,0,0,0,0,0,0
GW0389G1,0,0,0,0,0,0,0,0,0
GW0325G1,0,0,0,0,0,0,0,0,0
GW0354L2,0,0,0,0,0,0,0,0,0
GW0094G1,0,0,0,0,0,0,0,0,0
GW0335G2,0,0,0,0,0,0,0,0,0
GW0334G2,0,0,0,0,0,0,0,0,0
GW0415G2,0,0,0,0,0,0,0,0,0
GW0575G5,0,1,1,1,1,0,3,1,8
GW0357L2,0,0,0,0,0,0,0,0,0
GW0355L2,0,0,0,0,0,0,0,0,0
GW0315L2,0,0,0,0,0,0,0,0,0
GW0465L5,0,0,0,0,0,0,0,0,0
GW0410L3,0,0,0,0,0,0,0,0,0
GW0439L4,0,0,0,0,0,0,0,0,0
GW0477L2,0,0,0,0,0,0,0,0,0
GW0605L2,0,1,0,1,1,0,0,1,4
GW0260G1,0,0,0,0,0,0,0,0,0
GW0475L1,0,0,0,0,0,0,0,0,0
GW0325G2,0,0,0,0,0,0,0,0,0
GW0423G2,0,0,0,0,0,0,0,0,0
GW0265G2,0,0,0,0,0,0,0,0,0
W0911L5,0,0,0,1,0,0,0,0,1
GW0762L4,0,1,1,1,1,0,5,1,10
GW0770L5,0,1,1,1,1,0,10,1,15
GW0385L2,0,0,0,0,0,0,0,0,0
GW0637G3,0,1,1,2,1,0,0,1,6
GW0335G1,0,0,0,0,0,0,0,0,0
W1132G1,0,0,0,0,0,0,0,0,0
GW0402L2,0,0,0,0,0,0,0,0,0
W1142L2,0,0,0,0,0,0,0,0,0
GW0483L4,0,0,0,0,1,0,0,0,1
W1156L2,0,1,1,1,1,0,0,0,4
W1049G5,0,0,0,0,0,0,0,0,0
GW0759L3,0,0,1,1,0,0,0,1,3
GW0782G3,0,0,0,1,1,0,0,1,3
GW0768L1,0,0,0,0,0,0,0,0,0
GW0334G3,0,0,0,0,0,0,0,0,0
GW0767L3,0,1,1,1,1,0,2,1,7
GW0762L2,0,1,1,1,1,0,12,1,17
GW0767L5,0,1,1,1,1,0,4,1,9
GW0615L2,0,0,0,2,0,0,0,1,3
GW0771L2,0,1,1,1,1,0,1,1,6
GW0762L5,0,1,1,1,1,0,8,1,13
GW0793G2,0,1,1,1,1,0,0,1,5
GW0795G3,0,1,1,1,1,0,9,1,14
GW0770L3,0,1,1,1,1,0,1,1,6
GW0789G1,0,0,0,0,0,0,0,0,0
GW0793G3,0,0,0,1,1,0,0,0,2
GW0770L4,0,1,0,1,0,0,0,0,2
GW0790G1,0,1,1,1,0,0,0,0,3
GW0805G3,0,1,1,1,1,0,4,1,9
GW0769L2,0,1,1,1,1,0,8,1,13
GW0790G2,0,1,1,1,1,0,1,1,6
GW0782G1,0,1,1,1,1,0,1,1,6
GW0771L3,0,1,1,1,1,0,4,1,9
GW0770L1,0,0,0,1,0,0,0,0,1
GW0786G2,0,1,1,1,1,0,0,1,5
GW0770L2,0,1,1,1,1,0,10,1,15
GW0769L1,0,0,0,1,0,0,0,1,2
GW0769L3,0,1,1,1,1,0,0,1,5
GW0777L3,0,1,1,1,1,0,1,1,6
GW0799G2,0,1,1,1,1,0,0,1,5
GW0833G2,0,1,1,1,1,0,2,1,7
GW0782G2,0,1,1,1,1,0,13,1,18
GW0781G4,0,1,1,1,1,0,0,1,5
GW0804G4,0,1,1,1,1,0,11,1,16
GW0768L2,0,0,0,0,0,0,0,0,0
GW0804G2,0,1,1,1,1,0,4,1,9
GW0781G5,0,1,1,1,1,0,3,1,8
GW0803G1,0,1,0,1,1,0,0,1,4
GW0796G2,0,1,1,1,1,0,0,1,5
GW0774L3,0,0,0,1,1,0,0,1,3
GW0793G1,0,0,0,1,0,0,0,1,2
GW0767L2,0,1,1,1,1,0,6,1,11
GW0766L3,0,0,0,1,0,0,0,1,2
GW0833G1,0,1,1,2,0,0,15,1,20
GW0795G1,0,1,1,1,1,0,0,1,5
GW0795G4,0,1,1,1,1,0,18,1,23
GW0795G2,0,1,1,1,1,0,17,1,22
GW0786G1,0,1,1,1,1,0,16,1,21
GW0833G3,0,1,1,1,1,0,3,1,8
GW0789G4,0,1,1,1,1,0,7,1,12
GW0750L1,0,1,1,1,1,0,7,1,12
GW0752L1,0,1,1,1,1,0,0,1,5
GW0768L3,0,1,1,1,0,0,15,1,19
GW0744L2,0,1,1,1,1,0,9,1,14
GW0799G3,0,1,1,1,1,0,2,1,7
GW0800G2,0,1,1,1,1,0,2,1,7
GW0799G1,0,0,0,1,1,0,0,1,3
GW0800G1,0,1,1,1,1,0,1,1,6
GW0803G2,0,1,1,1,1,0,6,1,11
GW0746L2,0,1,1,1,0,0,5,1,9
Z01009L4MF,0,0,0,0,0,0,0,0,0
Y92004L2MF,0,0,0,0,0,0,0,0,0
Y98001L5MF,0,0,0,0,0,0,0,0,0
Y99011G9MF,0,0,0,1,0,0,0,1,2
Z02006L9MF,0,0,0,0,0,0,0,0,0
Y98010L9MF,0,0,0,0,0,0,0,0,0
Y83005G7MF,0,0,0,0,0,0,0,0,0
Y98008L1MF,0,0,0,0,0,0,0,0,0
Z01003L1MF,0,0,0,1,1,0,0,0,2
Y24014G9MF,0,0,0,0,0,0,0,0,0
Z12006L1MF,0,0,0,0,0,0,0,0,0
Y81006G5MF,0,0,0,0,0,0,0,0,0
Y99013G1MF,0,0,0,0,0,0,0,0,0
Z02004L7MF,0,0,0,0,0,0,0,0,0
Y70001G7MF,0,0,0,0,0,0,0,0,0
Z01010L9MF,0,0,0,0,0,0,0,0,0
Y93004L1MF,0,0,0,0,0,0,0,0,0
Z13001G7MF,0,0,0,0,0,0,0,0,0
Y71007L2MF,0,0,0,0,0,0,0,0,0
Y98009L3MF,0,0,0,1,1,0,0,0,2
Z12002L4MF,0,1,0,1,0,0,1,1,4
Y93006L9MF,0,0,0,0,0,0,0,0,0
Y99001G2MF,0,1,0,1,1,0,3,1,7
Y70002G2MF,0,0,0,0,0,0,0,0,0
Y92001L1MF,0,0,0,1,0,0,0,0,1
Y88002L1MF,0,0,0,0,0,0,0,0,0
Z07004G7MF,0,0,0,0,0,0,0,1,1
Z01004L1MF,0,1,0,1,2,0,1,1,6
Z03003L1MF,0,0,0,1,0,0,0,0,1
Y96002L1MF,0,0,0,0,1,0,0,0,1
Y78002L1MF,0,0,0,0,1,0,0,0,1
Y65002L2MF,0,0,0,0,0,0,0,0,0
Z01006L9MF,0,0,0,0,0,0,0,0,0
Z01013L1MF,0,0,0,0,0,0,0,0,0
Y83011G9MF,0,0,0,0,0,0,0,0,0
Z12003L1MF,0,0,0,0,0,0,0,1,1
Z16008G7MF,0,0,0,0,0,0,0,0,0
Y24002G2MF,0,0,0,0,0,0,0,0,0
Y83002G5MF,0,0,0,1,1,0,0,0,2
Y83008G1MF,0,0,0,1,1,0,0,1,3
Y99016G3MF,0,0,0,0,0,0,0,0,0
Y92005L1MF,0,0,0,0,0,0,0,0,0
Y92006L7MF,0,0,0,0,0,0,0,0,0
Z12005L1MF,0,0,0,0,0,0,0,0,0
Z07008G9MF,0,0,0,0,0,0,0,0,0
Z02005L4MF,0,0,0,0,0,0,0,0,0
Z01014L1MF,0,0,0,0,0,0,0,1,1
Y96004L1MF,0,0,0,0,0,0,0,0,0
Y16002L1MF,0,0,0,0,0,0,0,0,0
Z12001L9MF,0,0,0,0,0,0,0,0,0
Z12008L2MF,0,0,0,0,0,0,0,0,0
Z16002G2MF,0,0,0,0,0,0,0,0,0
Y81009G9MF,0,0,0,0,0,0,0,0,0
Y89002G2MF,0,0,0,0,0,0,0,0,0
Y99002G7MF,0,1,0,1,0,0,0,1,3
Z25001L1MF,0,0,0,1,1,0,1,1,4
Z22003L7MF,0,0,0,0,0,0,0,0,0
Z20002L1MF,0,0,0,1,0,0,0,1,2
Z25002L1MF,0,0,0,0,0,0,0,0,0
Z01019L9MF,0,0,0,0,0,0,0,0,0
Z14005G2MF,0,0,0,0,1,0,0,0,1
Z22002L1MF,0,0,0,0,0,0,0,0,0
Y56002L1MF,0,0,0,0,0,0,0,0,0
Z15003L1MF,0,0,0,0,0,0,0,0,0
Y98002L1MF,0,0,0,1,0,0,0,0,1
Z13002G7MF,0,0,0,0,0,0,0,0,0
Z20004L9MF,0,0,0,1,1,0,0,1,3
Z20001L4MF,0,1,0,1,0,0,0,0,2
Z14008G7MF,0,0,0,0,0,0,0,1,1
Z14007G9MF,0,0,0,0,0,0,0,0,0
Z05007L1MF,0,0,0,0,0,0,0,0,0
Z14011G7MF,0,0,0,0,1,0,0,0,1
Z22001L1MF,0,0,0,0,0,0,0,0,0
Z18004G9MF,0,0,0,0,0,0,0,0,0
Z18001G2MF,0,0,0,0,0,0,0,1,1
Z15004L7MF,0,0,0,0,0,0,0,0,0
Z17003G2MF,0,0,0,0,0,0,0,0,0
Z14009G9MF,0,0,0,0,0,0,0,0,0
Z17001G9MF,0,0,0,0,0,0,0,0,0
Z21009L1MF,0,0,0,0,0,0,0,0,0
Z25003L7MF,0,0,0,0,0,0,0,0,0
Z22004L1MF,0,0,0,0,0,0,0,0,0
Z01017L3MF,0,0,0,1,1,0,0,0,2
Z05006L2MF,0,0,0,0,0,0,0,0,0
Z18002G5MF,0,0,0,0,0,0,0,0,0
Z21006L1MF,0,0,0,0,0,0,0,0,0
Z18003G9MF,0,0,0,1,1,0,0,0,2
Z17004G9MF,0,0,0,0,0,0,0,0,0
Z20006L1MF,0,1,0,1,0,0,0,1,3
Z18006G7MF,0,0,0,0,0,0,0,0,0
Z35004G7MF,0,0,0,0,0,0,0,0,0
Z33003G5MF,0,0,0,1,1,0,0,1,3
Z26003G7MF,0,0,0,0,0,0,0,0,0
Z21007L1MF,0,0,0,0,0,0,0,0,0
Z35003G4MF,0,0,0,0,0,0,0,0,0
Z15002L1MF,0,0,0,0,0,0,0,0,0
Z32003G7MF,0,0,0,0,0,0,0,1,1
Z26005G4MF,0,0,0,0,0,0,0,0,0
Z34005L1MF,0,0,0,0,0,0,0,0,0
Z35001G7MF,0,0,0,0,0,0,0,0,0
Z35002G9MF,0,0,0,0,0,0,0,0,0
Z25004L9MF,0,0,0,0,0,0,0,0,0
Z33002G2MF,0,0,0,0,0,0,0,0,0
Z34004L3MF,0,0,0,0,0,0,0,0,0
Z26001G7MF,0,0,0,1,1,0,0,1,3
Z34002L9MF,0,0,0,0,0,0,0,0,0
Z26002G9MF,0,0,0,0,0,0,0,0,0
Z26004G2MF,0,0,0,0,0,0,0,0,0
Z32004G1MF,0,0,0,0,0,0,0,0,0
Z32002G9MF,0,0,0,0,0,0,0,0,0
Z39003G7MF,0,0,0,0,0,0,0,0,0
Z38003L3MF,0,0,0,0,0,0,0,0,0
Z32001G2MF,0,0,0,0,0,0,0,0,0
Z43002L1MF,0,0,0,1,0,0,0,0,1
Z38002L1MF,0,0,0,1,0,0,0,1,2
Z36001L3MF,0,0,0,0,0,0,0,0,0
Z40001G2MF,0,0,0,0,0,0,0,0,0
Z39005G3MF,0,0,0,0,0,0,0,0,0
Z43001L1MF,0,1,0,0,0,0,0,0,1
Z37002G2MF,0,0,0,0,0,0,0,0,0
Z37003G3MF,0,0,0,0,0,0,0,0,0
Z41002L1MF,0,1,0,0,0,0,0,1,2
Z40002G9MF,0,0,0,0,0,0,0,0,0
Y85002L1MF,0,0,0,0,1,0,0,0,1
Z15001L1MF,0,0,0,0,1,0,0,1,2
Z05003L1MF,0,0,0,0,1,0,0,1,2
Y81008G2MF,0,0,0,0,0,0,0,0,0
Y85001L1MF,0,0,0,1,0,0,0,0,1
Y27013G9MF,0,0,0,0,0,0,0,0,0
Y88003L1MF,0,0,0,1,0,0,0,0,1
Y87001L2MF,0,1,0,1,0,0,0,1,3
Z07002G2MF,0,0,0,0,1,0,0,0,1
Y92002L1MF,0,1,0,0,0,0,0,1,2
Y87002L1MF,0,0,0,1,0,0,0,0,1
Z07003G9MF,0,1,0,1,1,0,0,1,4
Y89003G2MF,0,0,0,0,0,0,0,0,0
Y83003G2MF,0,0,0,0,0,0,0,0,0
Y81007G7MF,0,0,0,0,1,0,0,0,1
Z13003G9MF,0,0,0,0,0,0,0,0,0
JC1L248M0085,0,0,1,1,1,0,1,1,5
JC1L114M0065,0,0,0,0,0,0,0,0,0
JC1L186M0025,0,0,0,0,0,0,0,0,0
JC1L168M0055,0,0,0,0,0,0,0,0,0
JC1L189M0075,0,0,0,0,1,0,0,1,2
JC1L168M0035,0,0,0,0,0,0,0,0,0
JC1L306M0015,0,0,0,0,1,0,0,0,1
JC1L251M0055,0,0,0,0,1,1,1,1,4
JC1L209M0045,0,0,0,1,1,2,0,0,4
JC1L230M0075,0,0,0,1,1,2,33,1,38
JC1L226M0055,0,0,0,0,0,0,6,0,6
JC1L209M0075,0,0,0,0,0,2,0,0,2
JC1L209M0055,0,0,0,0,2,2,0,1,5
JC1L222M0055,0,0,0,0,0,0,0,0,0
JC1L163M0225,0,0,0,0,0,0,0,0,0
JC1L224M0025,0,0,0,0,0,0,0,0,0
JC1L227M0065,0,0,0,0,0,0,6,0,6
JC1L208M0025,0,0,0,0,0,0,0,0,0
JC1L271M0035,0,0,0,0,0,0,0,0,0
JC1L264M0035,0,0,0,0,0,0,0,1,1
JC1L168M0045,0,0,0,0,0,0,0,0,0
JC1L230M0045,0,1,0,1,2,2,37,1,44
JC1L228M0055,0,0,0,1,0,0,0,0,1
JC1L268M0055,0,0,0,0,0,1,1,1,3
JC1L163M0275,0,0,0,0,0,0,0,0,0
JC1L228M0065,0,0,0,0,0,0,0,0,0
JC1L247M0075,0,0,0,0,0,0,6,0,6
JC1L163M0255,0,0,0,0,0,0,0,0,0
JC1L248M0065,0,0,0,1,1,2,1,0,5
JC1L228M0045,0,0,0,1,0,0,0,0,1
JC1L167M0055,0,0,0,0,0,0,0,0,0
JC1L185M0015,0,0,0,0,0,0,0,0,0
JC1L227M0025,0,0,0,0,0,0,0,1,1
JC1L073M0025,0,0,0,0,0,0,0,0,0
JC1L264M0015,0,0,0,0,0,0,0,0,0
JC1L264M0025,0,0,0,0,0,0,0,0,0
JC1L184M0025,0,0,0,0,0,0,0,0,0
JC1L226M0025,0,0,0,0,1,0,0,0,1
JC1L208M0055,0,0,0,1,1,2,0,0,4
JC1L247M0025,0,0,0,1,0,0,6,0,7
JC1L225M0095,0,0,0,0,0,0,3,0,3
JC1L183M0015,0,0,0,0,0,0,0,0,0
JC1L305M0065,0,0,1,1,1,2,3,1,9
JC1L222M0025,0,0,0,0,0,0,0,0,0
JC1L208M0035,0,0,0,0,1,2,0,0,3
JC1L113M0025,0,0,0,0,0,0,3,0,3
JC1L305M0045,0,0,0,1,1,1,5,1,9
JC1L232M0065,0,0,0,0,0,0,0,0,0
JC1L022M0045,0,0,0,0,0,0,5,0,5
JC1L167M0015,0,0,0,0,0,0,0,0,0
JC1L209M0065,0,1,0,1,0,1,3,1,7
JC1L112M0045,0,0,0,0,0,0,0,0,0
JC1L227M0045,0,0,0,0,0,0,10,0,10
JC1L227M0075,0,0,0,0,0,0,6,0,6
JC1L193M0055,0,1,0,1,1,0,9,1,13
JC1L229M0055,0,0,0,0,0,0,7,0,7
JC1L209M0025,0,0,0,0,0,0,0,0,0
JC1L249M0065,0,0,0,1,1,0,0,0,2
JC1L185M0025,0,0,0,0,0,0,0,0,0
JC1L269M0075,0,1,1,1,1,1,3,1,9
JC1L230M0025,0,0,1,1,1,0,0,0,3
JC1L230M0055,0,0,0,1,2,1,38,1,43
JC1L249M0025,0,0,0,1,1,1,2,1,6
JC1L270M0045,0,0,0,1,1,0,0,0,2
JC1L269M0045,0,0,0,0,0,1,0,0,1
JC1L190M0035,0,0,0,0,0,0,0,0,0
JC1L193M0025,0,0,0,0,0,0,0,0,0
JC1L112M0055,0,0,0,0,0,0,0,0,0
JC1L305M0035,0,0,0,1,1,1,3,1,7
JC1L306M0045,0,0,0,0,1,0,0,0,1
JC1L302M0055,0,0,0,0,0,1,2,1,4
JC1L184M0015,0,0,0,0,0,0,0,1,1
JC1L163M0045,0,0,0,0,0,0,0,1,1
JC1L271M0065,0,0,1,1,1,1,3,1,8
JC1L271M0045,0,1,2,1,1,1,1,1,8
JC1L251M0015,0,0,0,0,1,0,0,0,1
JC1L168M0075,0,0,0,0,0,0,0,0,0
JC1L229M0025,0,0,0,0,0,0,7,0,7
JC1L193M0015,0,0,0,0,0,0,0,0,0
JC1L304M0055,0,0,0,1,1,1,3,1,7
JC1L001M0135,0,0,0,0,0,0,0,0,0
JC1L222M0035,0,0,0,0,0,0,0,0,0
JC1L225M0085,0,1,0,0,0,0,3,0,4
JC1L264M0075,0,0,0,0,0,0,0,1,1
JC1L264M0045,0,0,0,0,0,0,0,1,1
JC1L115M0045,0,0,0,0,0,0,0,0,0
JC1L163M0015,0,0,0,0,0,0,0,0,0
JC1L167M0025,0,0,0,0,0,0,0,0,0
JC1L163M0025,0,0,0,0,0,0,0,0,0
JC1L163M0055,0,0,0,0,0,0,0,0,0
JC1L115M0025,0,0,0,0,0,0,0,0,0
JC1L163M0235,0,0,0,0,0,0,0,0,0
JC1L182M0015,0,0,0,0,0,0,0,0,0
JC1L177M0025,0,0,0,0,0,0,0,0,0
JC1L114M0075,0,0,0,0,0,0,0,0,0
JC1L182M0025,0,0,0,0,0,0,0,0,0
JC1L183M0025,0,0,0,0,0,0,0,0,0
JC1L193M0035,0,0,0,0,0,0,0,0,0
JC1L182M0035,0,0,0,0,0,0,0,0,0
JC1L183M0035,0,0,0,0,0,0,0,0,0
JC1L167M0065,0,0,0,0,0,0,0,0,0
JC1L223M0045,0,0,0,1,2,1,10,1,15
JC1L227M0015,0,0,0,0,0,0,0,0,0
JC1L186M0045,0,0,0,0,0,0,0,0,0
JC1L073M0035,0,0,0,0,0,0,0,0,0
JC1L177M0055,0,0,0,0,0,0,0,0,0
JC1L224M0015,0,0,0,0,0,0,0,0,0
JC1L304M0025,0,0,0,0,0,1,0,0,1
JC1L247M0015,0,0,0,0,0,0,0,0,0
JC1L305M0025,0,1,0,1,1,1,8,1,13
JC1L269M0025,0,0,0,1,0,0,0,1,2
JC1L247M0035,0,0,0,0,0,0,6,0,6
JC1L184M0045,0,0,0,0,0,0,0,0,0
JC1L209M0035,0,0,0,1,1,1,0,0,3
JC1L247M0055,0,0,0,0,0,0,6,0,6
JC1L208M0015,0,0,0,0,0,0,0,0,0
JC1L268M0065,0,0,0,0,0,0,3,1,4
JC1L224M0035,0,0,0,1,0,0,0,0,1
JC1L163M0215,0,0,0,0,0,0,0,0,0
JC1L226M0065,0,0,0,0,0,0,6,0,6
JC1L186M0065,0,0,0,0,0,0,0,0,0
JC1L168M0085,0,0,0,0,0,0,0,0,0
JC1L224M0095,0,1,0,1,2,1,26,1,32
JC1L167M0045,0,0,0,0,0,0,0,0,0
JC1L189M0015,0,0,0,0,0,0,0,0,0
JC1L304M0035,0,0,0,0,0,0,0,1,1
JC1L230M0035,0,0,0,0,0,0,0,0,0
JC1L229M0085,0,0,0,0,0,0,6,0,6
JC1L225M0015,0,0,0,0,0,0,0,0,0
JC1L189M0045,0,0,0,0,0,0,0,0,0
JC1L185M0035,0,0,0,0,0,0,0,0,0
JC1L112M0025,0,0,0,0,0,0,5,0,5
JC1L251M0075,0,0,0,0,0,0,0,1,1
JC1L268M0045,0,1,0,1,1,1,0,1,5
JC1L269M0055,0,0,1,0,0,0,1,0,2
JC1L305M0055,0,1,0,1,1,2,9,1,15
JC1L251M0025,0,0,0,0,0,0,0,0,0
JC1L163M0245,0,0,0,0,0,0,0,0,0
JC1L264M0065,0,0,0,0,1,0,0,0,1
JC1L226M0035,0,0,0,0,1,0,7,0,8
JC1L222M0075,0,0,0,0,0,0,0,0,0
JC1L302M0025,0,0,0,0,0,1,0,0,1
JC1L022M0035,0,0,0,0,0,0,5,0,5
JC1L193M0045,0,0,0,0,0,0,0,0,0
JC1L270M0055,0,0,0,0,1,1,0,1,3
JC1L167M0035,0,0,0,0,0,0,0,0,0
JC1L223M0065,0,0,0,1,2,1,0,0,4
JC1L163M0065,0,0,0,0,0,0,0,0,0
JC1L227M0035,0,0,0,0,0,0,8,0,8
JC1L067M0045,0,0,0,0,0,0,0,0,0
JC1L302M0045,0,0,0,1,0,1,0,0,2
JC1L304M0075,0,0,0,0,1,0,0,1,2
JC1L251M0065,0,0,0,0,0,0,1,0,1
JC1L209M0085,0,0,0,1,1,0,0,0,2
JC1L225M0105,0,1,0,0,0,0,5,0,6
JC1L190M0045,0,0,0,0,0,0,0,0,0
JC1L208M0075,0,1,0,1,2,1,3,1,9
JC1L249M0035,0,0,0,0,0,0,0,0,0
JC1L229M0035,0,0,0,0,0,0,11,0,11
JC1L224M0065,0,0,0,1,0,0,0,0,1
JC1L190M0065,0,0,0,0,0,0,0,0,0
JC1L229M0045,0,0,0,0,0,0,6,0,6
JC1L232M0015,0,0,0,0,0,0,0,0,0
JC1L304M0065,0,0,0,0,0,0,0,0,0
JC1L223M0015,0,0,0,0,0,0,0,0,0
JC1L228M0035,0,0,0,1,0,0,0,0,1
JC1L226M0045,0,0,0,0,0,0,6,0,6
JC1L208M0065,0,0,0,1,2,1,1,1,6
JC1G080L0025,0,0,0,0,0,0,0,0,0
JC1L022M0025,0,0,0,0,0,0,5,0,5
JC1L222M0045,0,0,0,0,0,0,0,0,0
JC1L227M0085,0,0,0,0,0,0,5,0,5
JC1L114M0055,0,0,0,0,0,0,0,0,0
JC1L224M0055,0,0,0,1,0,0,0,0,1
JC1L248M0025,0,0,0,1,1,0,0,0,2
JC1L073M0075,0,0,0,0,0,0,0,0,0
JC1L222M0015,0,0,0,0,0,0,0,0,0
JC1L247M0065,0,0,0,0,0,0,0,0,0
JC1L193M0065,0,0,0,0,0,0,0,0,0
JC1L226M0015,0,0,0,1,1,1,0,1,4
JC1L268M0035,0,0,0,0,0,0,0,0,0
JC1L163M0085,0,0,0,0,0,0,0,0,0
JC1L186M0055,0,0,0,0,0,0,0,0,0
JC1L177M0035,0,0,0,0,0,0,0,0,0
JC1L224M0045,0,1,0,1,0,0,0,0,2
JC1L073M0045,0,0,0,0,0,0,0,0,0
JC1L223M0025,0,0,0,0,0,0,0,0,0
JC1L305M0015,0,0,0,0,0,0,0,0,0
JC1L163M0035,0,0,0,0,0,0,0,0,0
JC1L230M0015,0,0,0,0,0,0,0,0,0
JC1L247M0045,0,0,0,0,0,0,6,0,6
JC1L228M0015,0,0,0,0,0,0,1,1,2
JC1L073M0015,0,0,0,0,0,0,0,0,0
JC1L190M0055,0,0,0,0,0,0,0,1,1
JC1L248M0075,0,0,0,1,1,1,2,1,6
JC1L189M0065,0,0,0,0,0,0,0,0,0
JC1L223M0055,0,1,0,1,2,1,9,1,15
JC1L113M0035,0,0,0,0,0,0,4,0,4
JC1L225M0035,0,0,0,0,0,0,0,0,0
JC1L001M0035,0,0,0,0,0,0,4,0,4
JC1L163M0265,0,0,0,0,0,0,0,0,0
JC1L248M0035,0,1,0,1,2,2,6,1,13
JC1L208M0045,0,0,0,1,3,1,0,0,5
JC1L001M0165,0,0,0,0,0,0,0,0,0
JC1L209M0015,0,0,0,0,1,0,0,0,1
JC1L222M0065,0,0,0,0,0,0,0,0,0
JC1L302M0035,0,0,0,0,0,0,0,1,1
JC1L228M0075,0,0,0,0,0,0,0,0,0
JC1L248M0055,0,1,0,1,2,1,18,1,24
JC1L268M0015,0,0,0,0,0,0,0,0,0
JC1L306M0055,0,0,1,1,1,1,0,1,5
JC1L073M0065,0,0,0,0,0,0,0,0,0
JC1L306M0035,0,0,0,1,1,2,4,1,9
JC1L249M0055,0,0,0,1,1,0,0,0,2
JC1L306M0065,0,0,0,1,1,1,0,1,4
JC1L270M0035,0,0,0,0,0,0,0,0,0
JC1L189M0055,0,0,0,0,0,0,0,0,0
JC1L022M0055,0,0,0,0,0,0,0,0,0
JC1L228M0085,0,0,0,0,0,0,0,0,0
JC1L224M0085,0,0,0,1,1,1,12,1,16
JC1L001M0045,0,0,0,0,0,0,4,0,4
JC1L225M0025,0,0,0,0,0,0,0,0,0
JC1L271M0015,0,1,0,0,0,0,0,0,1
JC1L225M0055,0,0,0,0,0,0,4,0,4
JC1L270M0065,0,1,1,1,1,1,3,1,9
JC1L228M0025,0,0,0,1,1,0,0,0,2
JC1L229M0015,0,0,0,0,0,0,0,0,0
JC1L225M0065,0,0,0,0,0,0,5,0,5
JC1L251M0045,0,0,0,1,1,2,4,1,9
JC1L248M0045,0,0,0,1,1,0,0,0,2
JC1L249M0015,0,0,0,0,0,0,0,0,0
JC1L189M0035,0,0,0,0,0,0,0,0,0
JC1L304M0045,0,0,0,1,2,0,0,0,3
JC1L269M0015,0,0,0,0,0,0,0,0,0
JC1L190M0075,0,0,0,0,0,0,0,0,0
JC1L227M0055,0,0,0,0,0,0,7,0,7
JC1L225M0045,0,0,0,0,0,0,4,0,4
JC1L163M0075,0,0,0,0,0,0,0,0,0
JC1L248M0015,0,0,1,0,0,0,0,0,1
JC1L067M0025,0,0,0,0,0,0,0,0,0
JC1L251M0035,0,0,0,0,1,0,0,0,1
JC1L269M0035,0,0,0,0,0,0,0,0,0
JC1L306M0025,0,0,0,0,0,1,0,0,1
JC1L269M0065,0,0,0,1,1,1,1,1,5
JC1L113M0045,0,0,0,0,0,0,4,0,4
JC1L189M0085,0,0,0,0,0,0,0,0,0
JC1L115M0035,0,0,0,0,0,0,0,0,0
JC1L001M0155,0,0,0,0,0,0,0,0,0
JC1L001M0125,0,0,0,0,0,0,0,0,0
JC1L001M0115,0,0,0,0,0,0,0,0,0
JC1L022M0075,0,0,0,0,0,0,3,0,3
JC1L190M0025,0,0,0,0,0,0,0,0,0
JC1L073M0055,0,0,0,0,0,0,0,0,0
JC1L249M0045,0,0,0,1,1,1,0,1,4
JC1L223M0035,0,0,0,1,3,1,0,0,5
JC1L022M0065,0,0,0,0,0,0,6,0,6
JC1L067M0055,0,0,0,0,0,0,0,0,0
JC1L017M0085,0,0,0,0,0,0,0,0,0
JC1L186M0015,0,0,0,0,0,0,0,0,0
JC1L001M0065,0,0,0,0,0,0,5,0,5
JC1L112M0035,0,0,0,0,0,0,0,0,0
JC1L184M0035,0,0,0,0,0,0,0,0,0
JC1L186M0035,0,0,0,0,0,0,0,0,0
JC1L302M0065,0,0,0,0,0,0,0,1,1
JC1L001M0055,0,0,0,0,0,0,5,0,5
JC1L067M0015,0,0,0,0,0,0,0,0,0
JC1L067M0035,0,0,0,0,0,0,0,0,0
JC1L302M0015,0,0,0,0,0,0,0,0,0
JC1L001M0025,0,0,0,0,0,0,4,0,4
JC1L059M0045,0,0,0,0,0,0,0,0,0
JC1L067M0065,0,0,0,0,0,0,0,0,0
JC1L304M0015,0,0,0,1,1,0,1,1,4
JC1L115M0055,0,0,0,1,0,0,0,0,1
JC1L225M0075,0,0,0,0,0,0,5,0,5
JC1L057M0275,0,0,0,0,0,0,0,0,0
JC1L010M0595,0,0,0,0,0,0,0,0,0
JC1L061M0075,0,0,0,0,0,0,0,0,0
JC1L010M0125,0,0,0,0,0,0,0,0,0
JC1L032M0305,0,0,0,0,0,0,0,0,0
JC1L078M0075,0,0,0,0,0,0,0,0,0
JC1L079M0055,0,0,0,0,0,0,0,0,0
JC1L059M0075,0,0,0,0,0,0,0,0,0
JC1L023M0105,0,0,0,0,0,0,0,0,0
JC1L074M0035,0,0,0,0,0,0,0,0,0
JC1L033M0065,0,0,0,0,0,0,0,0,0
JC1L306M0075,0,0,1,0,0,1,0,0,2
JC1L189M0025,0,0,0,0,0,0,0,0,0
JC1L002M0055,0,0,0,0,0,0,0,0,0
JC1L032M0285,0,0,0,0,0,0,0,0,0
JC1L059M0055,0,0,0,0,0,0,0,0,0
JC1L033M0015,0,0,0,0,0,0,0,0,0
JC1L061M0105,0,0,0,0,0,0,0,0,0
JC1L046M0065,0,0,0,0,0,0,0,0,0
JC1L085M0065,0,0,0,0,0,0,0,0,0
JC1L045M0085,0,0,0,0,0,0,0,0,0
JC1L010M0605,0,0,0,0,0,0,0,0,0
JC1L076M0135,0,0,0,0,0,0,0,0,0
JC1L031M0075,0,0,0,0,0,0,0,0,0
JC1L033M0055,0,0,0,0,0,0,0,0,0
JC1L033M0025,0,0,0,0,0,0,0,0,0
JC1L077M0075,0,0,0,0,0,0,0,0,0
JC1L059M0025,0,0,0,0,0,0,0,0,0
JC1L072M0025,0,0,0,0,0,0,0,0,0
JC1L057M0075,0,0,0,0,0,0,0,0,0
JC1L002M0045,0,0,0,0,0,0,0,0,0
JC1L079M0065,0,0,0,0,0,0,0,0,0
JC1L061M0095,0,0,0,0,0,0,0,0,0
JC1L010M0585,0,0,0,0,0,0,0,0,0
JC1L057M0335,0,0,0,0,0,0,0,0,0
JC1L028M0055,0,0,0,0,0,0,0,0,0
JC1L072M0055,0,0,0,0,0,0,0,0,0
JC1L076M0125,0,0,0,0,0,0,0,0,0
JC1L032M0115,0,0,0,0,0,0,0,0,0
JC1L072M0015,0,0,0,0,0,0,0,0,0
JC1L059M0065,0,0,0,0,0,0,0,0,0
JC1L085M0095,0,0,0,0,0,0,0,0,0
JC1L046M0105,0,0,0,0,0,0,0,0,0
JC1L057M0065,0,0,0,0,0,0,0,0,0
JC1L045M0075,0,0,0,0,0,0,0,0,0
JC1L060M0065,0,0,0,0,0,0,0,0,0
JC1L042M0095,0,0,0,0,0,0,0,0,0
JC1L087M0055,0,0,0,0,0,0,0,0,0
JC1L061M0045,0,0,0,0,0,0,0,0,0
JC1L056M0025,0,0,0,0,0,0,0,0,0
JC1L050M0085,0,0,0,0,0,0,0,0,0
JC1L061M0055,0,0,0,0,0,0,0,0,0
JC1L076M0145,0,0,0,0,0,0,0,0,0
JC1L087M0085,0,0,0,0,0,0,0,0,0
JC1L078M0055,0,0,0,0,0,0,0,0,0
JC1L046M0075,0,0,0,0,0,0,0,0,0
JC1L050M0295,0,0,0,0,0,0,0,0,0
JC1L010M0245,0,0,0,0,0,0,0,0,0
JC1L050M0265,0,0,0,0,0,0,0,0,0
JC1L010M0465,0,0,0,0,0,0,0,0,0
JC1L050M0285,0,0,0,0,0,0,0,0,0
JC1L059M0035,0,0,0,0,0,0,0,0,0
JC1L074M0065,0,0,0,0,0,0,0,0,0
JC1L010M0505,0,0,0,0,0,0,0,0,0
JC1L056M0055,0,0,0,0,0,0,0,0,0
JC1L078M0035,0,0,0,0,0,0,0,0,0
JC1L072M0035,0,0,0,0,0,0,0,0,0
JC1L045M0105,0,0,0,0,0,0,0,0,0
JC1L050M0115,0,0,0,0,0,0,0,0,0
JC1L046M0085,0,0,0,0,0,0,0,0,0
JC1L072M0045,0,0,0,0,0,0,0,0,0
JC1L057M0345,0,0,0,0,0,0,0,0,0
JC1L078M0065,0,0,0,0,0,0,0,0,0
JC1L046M0095,0,0,0,0,0,0,0,0,0
JC1L085M0075,0,0,0,0,0,0,0,0,0
JC1L087M0065,0,0,0,0,0,0,0,0,0
JC1L032M0255,0,0,0,0,0,0,0,0,0
JC1L057M0325,0,0,0,0,0,0,0,0,0
JC1L050M0255,0,0,0,0,0,0,0,0,0
JC1L061M0065,0,0,0,0,0,0,0,0,0
JC1L046M0055,0,0,0,0,0,0,0,0,0
JC1L061M0085,0,0,0,0,0,0,0,0,0
DW00100684,0,0,0,0,0,0,0,0,0
DW00100686,0,0,0,1,0,0,0,0,1
DW00100687,0,0,1,0,0,0,0,0,1
DW00100208,0,1,0,1,0,0,0,1,3
DW00100689,0,0,0,1,0,0,0,0,1
DW00100717,0,0,0,0,0,0,0,0,0
DW00100215,0,0,0,0,0,0,0,0,0
DW00100683,0,0,0,1,0,0,0,0,1
DW00100228,0,0,0,0,0,0,0,1,1
DW00100473,0,0,1,0,0,0,0,0,1
DW00100313,0,0,0,0,0,0,0,0,0
DW00100230,0,1,0,1,0,0,0,1,3
DW00100590,0,0,0,0,0,0,0,0,0
DW00100431,0,0,1,0,0,0,0,1,2
DW00100613K,0,0,0,0,0,0,0,0,0
DW00100449,0,0,0,0,0,0,0,0,0
DW00100468,0,0,0,0,0,0,0,0,0
DW00100579,0,0,0,0,0,0,0,0,0
DW00100617K,0,0,0,0,0,0,0,0,0
DW00100625K,0,0,0,0,0,0,0,0,0
DW00100706,0,1,0,0,0,0,0,0,1
DW00100162,0,1,0,0,0,0,1,1,3
DW00100720,0,1,0,0,0,0,0,0,1
DW00100715,0,1,0,0,0,0,0,0,1
DW00100163,0,0,0,0,0,0,0,1,1
DW00100207,0,0,0,0,0,0,0,0,0
DW00100213K,0,0,0,0,0,0,0,0,0
DW00100415K,0,0,0,0,0,0,0,0,0
DW00100249K,0,0,0,0,0,0,0,0,0
DW00100692,0,0,0,0,0,0,0,0,0
DW00100401K,0,0,0,0,0,0,0,0,0
DW00100688,0,1,0,0,0,0,0,0,1
DW00100545K,0,0,0,0,0,0,0,0,0
DW00100485K,0,0,0,0,0,0,0,0,0
DW00100439,0,0,0,0,0,0,0,0,0
DW00100614K,0,0,0,0,0,0,0,0,0
DW00100616K,0,0,0,0,0,0,0,0,0
DW00100565K,0,0,0,0,0,0,0,0,0
DW00100642K,0,0,0,0,0,0,0,0,0
DW00100562K,0,0,0,0,0,0,0,0,0
DW00100633K,0,0,0,0,0,0,0,0,0
DW00100626K,0,0,0,0,0,0,0,0,0
DW00100634K,0,0,0,0,0,0,0,0,0
DW00100358,0,1,0,0,0,0,0,0,1
DW00100535,0,0,0,1,0,0,0,1,2
DW00100701,0,1,0,1,0,0,0,0,2
DW00100220,0,0,0,0,0,0,0,0,0
DW00100306K,0,0,0,0,0,0,0,0,0
DW00100703,0,0,1,0,0,0,0,0,1
DW00100202,0,0,0,1,0,0,1,1,3
DW00100421,0,0,0,0,0,0,0,0,0
DW00100307K,0,0,0,0,0,0,0,0,0
DW00100632K,0,0,0,0,0,0,0,0,0
DW00100359,0,0,1,1,0,0,0,0,2
DW00100538,0,0,0,1,0,0,0,1,2
DW00100645K,0,0,0,0,0,0,0,0,0
DW00100479,0,1,0,1,0,0,0,1,3
DW00100730,0,0,1,0,0,0,0,0,1
DW00100458,0,0,0,1,0,0,1,1,3
DW00100644K,0,0,0,0,0,0,0,0,0
DW00100700,0,0,0,1,0,0,0,0,1
DW00100690,0,0,0,0,0,0,0,0,0
DW00100631K,0,0,0,0,0,0,0,0,0
DW00100639K,0,0,0,0,0,0,0,0,0
DW00100721,0,1,0,0,0,0,0,0,1
DW00100161,0,1,0,0,0,0,1,1,3
DW00100620K,0,0,0,0,0,0,0,0,0
DW00100685,0,0,0,1,0,0,0,0,1
DW00100682,0,1,0,1,0,0,0,0,2
DW00100719,0,0,0,0,0,0,0,0,0
DW00100641K,0,0,0,0,0,0,0,0,0
DW00100696,0,0,0,1,0,0,0,0,1
DW00100517,0,0,0,1,0,0,0,0,1
DW00100640K,0,0,0,0,0,0,0,0,0
DW00100699,0,1,0,0,0,0,0,0,1
DW00100509K,0,0,0,0,0,0,0,0,0
DW00100698,0,0,0,0,0,0,0,0,0
DW00100705,0,0,1,0,0,0,0,0,1
DW00100308K,0,0,0,0,0,0,0,0,0
DW00100695,0,0,0,1,0,0,0,0,1
DW00100704,0,0,0,0,0,0,0,0,0
DW00100636K,0,0,0,0,0,0,0,0,0
DW00100189K,0,0,0,0,0,0,0,0,0
DW00100202K,0,0,0,0,0,0,0,0,0
DW00100702,0,0,0,0,0,0,0,0,0
DW00100217K,0,0,0,0,0,0,0,0,0
DW00100210K,0,0,0,0,0,0,0,0,0
DW00100175K,0,0,0,0,0,0,0,0,0
DW00100305,0,0,0,0,0,0,0,1,1
DW00100231K,0,0,0,0,0,0,0,0,0
DW00100247K,0,0,0,0,0,0,0,0,0
DW00100219K,0,0,0,0,0,0,0,0,0
DW00100172K,0,0,0,0,0,0,0,0,0
DW00100348K,0,0,0,0,0,0,0,0,0
DW00100420K,0,0,0,0,0,0,0,0,0
DW00100419K,0,0,0,0,0,0,0,0,0
DW00100479K,0,0,0,0,0,0,0,0,0
DW00100437K,0,0,0,0,0,0,0,0,0
DW00100661,0,1,0,1,0,0,0,0,2
DW00100517K,0,0,0,0,0,0,0,0,0
DW00100671,0,1,0,1,0,0,0,0,2
DW00100212K,0,0,0,0,0,0,0,0,0
DW00100643K,0,0,0,0,0,0,0,0,0
DW00100432,0,1,0,1,0,0,3,1,6
DW00100518,0,1,0,1,0,0,1,1,4
DW00100218,0,0,0,0,0,0,1,1,2
DW00100691,0,0,0,1,0,0,0,0,1
DW00100561,0,0,0,0,0,0,0,1,1
DW00100348,0,0,1,0,0,0,0,1,2
DW00100461,0,0,0,0,0,0,0,0,0
DW00100462K,0,0,0,0,0,0,0,0,0
DW00100716,0,1,0,0,0,0,0,0,1
DW00100593,0,1,0,1,0,0,0,0,2
DW00100681,0,0,1,0,0,0,0,0,1
DW00100637K,0,0,0,0,0,0,0,0,0
DW00100666,0,0,1,0,0,0,0,0,1
DW00100203,0,1,0,1,0,0,0,1,3
DW00100693,0,0,0,1,0,0,0,0,1
DW00100480,0,1,0,0,0,0,0,1,2
DW00100246,0,0,0,0,0,0,0,1,1
DW00100346,0,0,0,0,0,0,0,0,0
DW00100436,0,0,0,0,0,0,0,0,0
DW00100245,0,0,0,0,0,0,0,1,1
DW00100697,0,0,0,1,0,0,0,0,1
DW00100718,0,0,1,0,0,0,0,0,1
DW00100635K,0,0,0,0,0,0,0,0,0
DW00100164,0,0,0,0,0,0,0,1,1
DW00100206,0,0,0,0,0,0,0,1,1
DW00100035,0,0,0,0,0,0,0,1,1
DW00100708,0,0,0,1,0,0,0,0,1
DW00100711,0,1,0,0,0,0,0,0,1
DW00100707,0,0,0,1,0,0,0,0,1
DW00100009K,0,0,0,0,0,0,0,0,0
DW00100124K,0,0,0,0,0,0,0,0,0
DW00100710,0,1,0,0,0,0,0,0,1
DW00100714,0,1,0,0,0,0,0,0,1
DW00100129K,0,0,0,0,0,0,0,0,0
DW00100139,0,0,0,0,0,0,0,1,1
DW00100133K,0,0,0,0,0,0,0,0,0
DW00100713,0,0,0,0,0,0,0,0,0
DW00100150K,0,0,0,0,0,0,0,0,0
DW00100426K,0,0,0,0,0,0,0,0,0
DW00100472K,0,0,0,0,0,0,0,0,0
DW00100709,0,0,0,1,0,0,0,0,1
DW00100475,0,0,0,0,0,0,0,0,0
DW00100210,0,0,0,1,0,0,0,1,2
DW00100662,0,1,0,1,0,0,0,0,2
DW00100614,0,0,0,1,0,0,0,0,1
DW00100580,0,1,0,1,0,0,0,1,3
DW00100617,0,1,0,1,0,0,0,1,3
DW00100516K,0,0,0,0,0,0,0,0,0
DW00100578,0,1,0,0,0,0,0,1,2
DW00100477K,0,0,0,0,0,0,0,0,0
DW00100663,0,0,1,1,0,0,0,0,2
DW00100536,0,0,0,1,0,0,0,1,2
DW00100214K,0,0,0,0,0,0,0,0,0
DW00100694,0,0,0,0,0,0,0,0,0
DW00100403,0,1,0,0,0,0,2,1,4
DW00100668,0,0,0,1,0,0,0,0,1
DW00100478K,0,0,0,0,0,0,0,0,0
DW00100209,0,1,0,1,0,0,2,1,5
DW00100669,0,0,1,0,0,0,0,0,1
DW00100727,0,0,1,0,0,0,0,0,1
DW00100667,0,1,0,1,0,0,0,0,2
DW00100725,0,0,1,0,0,0,0,0,1
DW00100306,0,0,0,0,0,0,1,1,2
DW00100459,0,1,0,1,0,0,3,1,6
DW00100127,0,0,0,0,0,0,0,0,0
DW00100628K,0,0,0,0,0,0,0,0,0
DW00100514,0,0,0,0,0,0,0,0,0
DW00100212,0,0,1,1,0,0,2,1,5
DW00100457,0,1,0,1,0,0,0,1,3
DW00100474,0,1,0,1,0,0,1,1,4
DW00100483,0,0,0,0,0,0,0,0,0
DW00100664,0,1,0,1,0,0,0,0,2
DW00100555,0,0,0,0,0,0,0,0,0
DW00100602,0,1,0,0,0,0,0,0,1
DW00100401,0,1,0,1,0,0,0,1,3
DW00100481K,0,0,0,0,0,0,0,0,0
DW00100513,0,0,1,0,0,0,1,1,3
DW00100566K,0,0,0,0,0,0,0,0,0
DW00100359K,0,0,0,0,0,0,0,0,0
DW00100672,0,0,1,1,0,0,0,0,2
DW00100665,0,0,0,0,0,0,0,0,0
DW00100670,0,1,0,1,0,0,0,0,2
DW00100161K,0,0,0,0,0,0,0,0,0
DW00100425,0,0,0,0,0,0,0,0,0
DW00100638K,0,0,0,0,0,0,0,0,0
DW00100520K,0,0,0,0,0,0,0,0,0
DW00100349K,0,0,0,0,0,0,0,0,0
DW00100470,0,1,0,1,0,0,1,1,4
DW00100484,0,0,1,1,0,0,0,0,2
DW00100347K,0,0,0,0,0,0,0,0,0
DW00100434K,0,0,0,0,0,0,0,0,0
DW00100127K,0,0,0,0,0,0,0,0,0
DW00100543,0,0,0,0,0,0,0,0,0
DW00100642,0,0,0,1,0,0,0,0,1
DW00100639,0,0,0,1,0,0,0,0,1
DW00100303K,0,0,0,0,0,0,0,0,0
DW00100148,0,0,0,0,0,0,0,0,0
DW00100629,0,0,0,1,0,0,0,0,1
DW00100640,0,0,0,0,0,0,0,0,0
DW00100712,0,0,0,0,0,0,0,0,0
DW00100484K,0,0,0,0,0,0,0,0,0
DW00100622K,0,0,0,0,0,0,0,0,0
DW00100644,0,0,0,0,0,0,0,0,0
DW00100459K,0,0,0,0,0,0,0,0,0
DW00100421K,0,0,0,0,0,0,0,0,0
DW00100345,0,0,0,1,0,0,0,1,2
DW00100646,0,1,0,1,0,0,0,0,2
DW00100476K,0,0,0,0,0,0,0,0,0
DW00100464K,0,0,0,0,0,0,0,0,0
DW00100581,0,1,0,1,0,0,0,1,3
DW00100597,0,1,0,1,0,0,1,1,4
DW00100534,0,0,0,1,0,0,0,1,2
DW00100510,0,1,0,1,0,0,4,1,7
DW00100125K,0,0,0,0,0,0,0,0,0
DW00100599K,0,0,0,0,0,0,0,0,0
DW00100201K,0,0,0,0,0,0,0,0,0
DW00100304K,0,0,0,0,0,0,0,0,0
DW00100515,0,0,0,0,0,0,0,0,0
DW00100211K,0,0,0,0,0,0,0,0,0
DW00100443,0,0,0,1,0,0,0,1,2
DW00100435K,0,0,0,0,0,0,0,0,0
DW00100541,0,0,0,1,0,0,0,0,1
DW00100358K,0,0,0,0,0,0,0,0,0
DW00100213,0,0,0,1,0,0,1,1,3
DW00100415,0,1,0,1,0,0,0,1,3
DW00100592,0,1,0,1,0,0,0,1,3
DW00100342,0,0,0,0,0,0,0,1,1
DW00100211,0,0,0,0,0,0,0,0,0
DW00100520,0,0,0,0,0,0,0,0,0
DW00100470K,0,0,0,0,0,0,0,0,0
DW00100437,0,1,0,0,0,0,0,0,1
DW00100471K,0,0,0,0,0,0,0,0,0
DW00100556,0,0,0,0,0,0,0,1,1
DW00100632,0,0,0,1,0,0,0,0,1
DW00100458K,0,0,0,0,0,0,0,0,0
DW00100433,0,0,0,0,0,0,0,1,1
DW00100414,0,0,0,1,0,0,0,0,1
DW00100482,0,0,0,1,0,0,0,1,2
DW00100471,0,0,1,0,0,0,2,1,4
DW00100149K,0,0,0,0,0,0,0,0,0
DW00100343,0,0,0,1,0,0,0,0,1
DW00100350K,0,0,0,0,0,0,0,0,0
DW00100217,0,0,0,0,0,0,1,1,2
DW00100006K,0,0,0,0,0,0,0,0,0
DW00100219,0,0,0,0,0,0,0,1,1
DW00100036,0,0,0,0,0,0,0,0,0
DW00100307,0,0,0,0,0,0,0,0,0
DW00100527,0,0,0,0,0,0,0,1,1
DW00100476,0,0,0,0,0,0,0,0,0
DW00100349,0,0,0,0,0,0,0,1,1
DW00100557,0,0,0,0,0,0,0,1,1
DW00100516,0,0,0,0,0,0,0,0,0
DW00100528,0,0,0,0,0,0,0,0,0
DW00100350,0,0,0,0,0,0,0,1,1
DW00100477,0,0,0,0,0,0,0,0,0
DW00100521,0,0,0,0,0,0,0,0,0
DW00100462,0,0,0,0,0,0,0,1,1
DW00100347,0,0,0,0,0,0,0,0,0
DW00100591,0,0,0,0,0,0,0,0,0
DW00100731,0,0,0,0,0,0,0,0,0
JC1L264M0055,0,0,0,1,1,0,0,0,2
RC5G018M0075,0,0,0,0,1,1,0,0,2
RC5L025M0055,0,0,0,0,0,0,0,0,0
RC5G018M0065,0,0,0,0,1,1,0,0,2
RC5G047M0065,0,0,0,0,1,0,0,0,1
RC5L011M0075,0,0,0,0,0,0,0,0,0
RC5G011L0025,0,0,0,0,0,0,0,0,0
RC5G018P0045,0,0,0,0,0,0,0,0,0
RC5L030M0085,0,0,0,0,0,0,0,0,0
RC5L056M0075,0,0,0,0,0,0,0,0,0
RC5L052M0045,0,0,0,0,0,2,0,0,2
RC5G013M0115,0,0,0,0,1,1,0,0,2
RC5L041M0085,0,0,0,0,1,1,0,0,2
RC5L004M0085,0,0,0,0,0,0,0,0,0
RC5G099M0075,0,0,0,0,1,2,0,0,3
RC5L063M0075,0,0,0,0,0,0,0,0,0
RC5L092M0045,0,0,0,0,1,1,0,0,2
RC5L052M0025,0,0,0,0,0,1,0,0,1
RC5L030M0065,0,0,0,0,0,0,0,0,0
RC5G047M0085,0,0,0,0,1,1,0,0,2
RC5L092M0035,0,0,0,0,0,1,0,0,1
RC5G012M0085,0,0,0,0,0,0,0,0,0
RC5L030M0105,0,0,0,0,0,0,0,0,0
RC5G016P0045,0,0,0,0,0,0,0,0,0
RC5G018M0095,0,0,0,0,0,0,0,0,0
RC5G044P0085,0,0,0,0,1,1,0,0,2
RC5G011L0035,0,0,0,0,0,0,0,0,0
RC5L052M0065,0,0,0,0,0,0,0,0,0
RC5L098M0055,0,0,0,0,0,0,0,0,0
RC5G013M0105,0,0,0,0,0,0,0,0,0
RC5G016M0085,0,0,0,0,1,1,0,0,2
RC5L005M0075,0,0,0,0,0,0,0,0,0
RC5G047M0055,0,0,0,0,0,0,0,0,0
RC5G046L0025,0,0,0,0,0,0,0,0,0
RC5L005M0105,0,0,0,0,0,0,0,0,0
RC5L063M0095,0,0,0,0,0,0,0,0,0
RC5G042M0065,0,0,0,0,0,0,0,0,0
RC5L052M0035,0,0,0,0,0,0,0,0,0
RC5G100M0085,0,0,0,0,1,1,0,0,2
AX1872,0,1,1,1,0,0,0,0,3
AX5384,0,0,0,1,0,0,0,0,1
AX1873,0,0,0,0,0,0,0,0,0
AX1723,0,0,1,2,0,1,0,0,4
AX1721,2,1,1,1,0,1,0,0,6
AX1871,0,0,0,0,0,0,0,0,0
AX2137,0,0,0,0,0,0,0,0,0
AX2133,0,1,1,2,0,0,0,0,4
AX2103,1,1,1,2,0,1,0,0,6
AX5311,0,1,1,1,0,0,0,0,3
AX2748,0,0,1,0,0,1,0,0,2
AX1335,5,1,1,1,0,1,0,0,9
AX2413,0,1,0,1,0,1,0,0,3
AX1720,0,1,0,1,0,1,0,0,3
AX1854,0,1,1,0,0,0,0,0,2
AX2104,1,1,1,1,0,1,0,0,5
AX2144,1,1,1,1,0,1,0,0,5
AX2747,0,0,0,0,0,0,0,0,0
AX2430,0,0,1,1,0,0,0,0,2
AX2434,0,1,1,0,0,0,0,0,2
AX2169,0,1,1,1,0,1,0,0,4
AX2736,0,1,1,1,0,1,0,0,4
AX2429,0,1,1,0,0,0,0,0,2
AX2858,0,0,1,0,0,0,0,0,1
AX2194,0,1,1,1,0,1,0,0,4
AX1731,0,1,1,1,0,0,0,0,3
AX2719,0,1,1,2,0,1,0,0,5
AX2745,0,0,1,1,0,0,0,0,2
AX1870,0,1,1,1,0,1,0,0,4
AX5258,0,0,0,1,0,1,0,0,2
AX5602,0,0,0,0,0,1,0,0,1
AX5548,1,1,1,1,0,1,0,0,5
AX5573,0,1,1,0,0,0,0,0,2
AX1326,0,1,1,1,0,0,0,0,3
AX5328,0,0,0,1,0,0,0,0,1
AX2706,0,1,0,1,0,1,0,0,3
AX2443,0,1,1,1,0,1,0,0,4
AX5537,0,1,1,1,0,0,0,0,3
AX1865,0,1,1,1,0,1,0,0,4
AX5324,0,1,1,1,0,1,0,0,4
AX1734,0,0,0,0,0,0,0,0,0
AX5262,0,0,0,0,0,0,0,0,0
AX5911,0,0,0,0,0,1,0,0,1
AX2444,0,1,1,0,0,0,0,0,2
AX5912,0,0,0,0,0,0,0,0,0
AX5536,1,1,1,1,0,0,0,0,4
AX2602,0,1,1,1,0,0,0,0,3
AX1869,0,0,0,0,0,0,0,0,0
AX5270,0,1,0,0,0,0,0,0,1
AX5901,0,1,0,0,0,0,0,0,1
AX2746,0,0,0,0,0,0,0,0,0
AX2164,0,0,0,0,0,0,0,0,0
AX5592,0,1,1,1,0,0,0,0,3
AX1874,0,1,1,0,0,0,0,0,2
AX5591,0,0,1,0,0,0,0,0,1
AX2446,0,0,0,0,0,0,0,0,0
AX1878,0,1,1,1,0,0,0,0,3
AX7154,0,1,0,0,0,0,0,0,1
AX5587,0,0,0,1,0,0,0,0,1
AX1741,0,0,0,0,0,0,0,0,0
AX1875,1,1,1,1,0,1,0,0,5
AX1882,0,1,1,1,0,1,0,0,4
AX5658,0,1,0,1,0,1,0,0,3
AX5595,0,0,0,0,0,1,0,0,1
AX1960,0,0,0,1,0,0,0,0,1
AX1727,0,0,0,0,0,0,0,0,0
AX5912I,0,0,0,0,0,0,0,0,0
AX7145,0,0,1,0,0,0,0,0,1
AX1954,0,0,1,0,0,0,0,0,1
AX7134SET,0,0,1,0,0,0,0,0,1
AX1735,0,1,0,0,0,0,0,0,1
AX2870,0,0,1,0,0,0,0,0,1
AX1739,0,1,1,1,0,0,0,0,3
AX1737,0,1,1,0,0,0,0,0,2
AX1740,0,1,1,1,0,1,0,0,4
AX4607,0,0,0,0,0,0,0,0,0
AX5578,0,0,1,0,0,0,0,0,1
AX2451,0,0,1,0,0,0,0,0,1
AX7105,0,0,1,1,0,0,0,0,2
AX5271,0,0,0,1,0,0,0,0,1
AX2450,0,0,0,0,0,0,0,0,0
AX5329,0,1,1,0,0,1,0,0,3
AX2902,0,0,0,0,0,0,0,0,0
AX1951,0,2,0,1,0,1,0,0,4
AX2756,0,1,0,1,0,0,0,0,2
AX7152,0,0,0,0,0,0,0,0,0
AX2098,0,0,0,0,0,0,0,0,0
AX7132SET,0,0,0,0,0,0,0,0,0
AX2761,0,2,1,0,0,0,0,0,3
AX1827,0,0,0,0,0,0,0,0,0
AX1957,0,1,0,0,0,0,0,0,1
AX2872,0,1,0,1,0,0,0,0,2
AX1958,1,1,1,1,0,1,0,0,5
AX2453,0,1,1,1,0,1,0,0,4
AX5661,0,0,0,0,0,0,0,0,0
AX1962,0,1,1,1,0,1,0,0,4
AX5581,0,0,1,1,0,1,0,0,3
AX1876,0,1,1,1,0,1,0,0,4
AX2419,0,0,0,0,0,0,0,0,0
AX2452,0,0,0,0,0,0,0,0,0
AX1956,1,1,1,1,0,1,0,0,5
AX2702,0,0,0,0,0,0,0,0,0
AX2624,0,0,0,0,0,0,0,0,0
AX2752,0,1,0,0,0,0,0,0,1
AX1959,1,2,1,1,0,0,0,0,5
AX5662,0,1,0,1,0,1,0,0,3
AX2861,0,0,0,0,0,0,0,0,0
AX4331,0,1,0,1,0,0,0,0,2
AX1961,0,1,0,1,0,0,0,0,2
AX7146SET,0,1,0,1,0,1,0,0,3
AX1881,0,0,1,1,0,1,0,0,3
AX1952,0,1,1,1,0,0,0,0,3
AX5617,0,0,0,0,0,1,0,0,1
AX1746,0,0,0,0,0,0,0,0,0
AX1880,0,1,1,1,0,1,0,0,4
AX5577,0,0,0,1,0,0,0,0,1
AX7153SET,0,1,1,1,0,1,0,0,4
AX1732,0,1,1,2,0,1,0,0,5
AX2871,0,1,1,0,0,0,0,0,2
AX1722,2,1,1,1,0,1,0,0,6
AX2189,1,1,1,2,0,1,0,0,6
AX2437,0,1,1,0,0,0,0,0,2
AX2440,0,0,0,1,0,0,0,0,1
AX7156SET,0,0,0,0,0,0,0,0,0
AX2086,0,0,0,0,0,0,0,0,0
AX5275,0,0,0,1,0,0,0,0,1
AX5383,0,0,0,0,0,0,0,0,0
AX2449,0,0,0,1,0,0,0,0,1
AX7101,0,1,1,1,0,1,0,0,4
AX5535,0,1,0,1,0,0,0,0,2
AX5580,0,0,1,1,0,0,0,0,2
AX2508,0,0,1,1,0,1,0,0,3
AX2701,0,1,0,2,0,1,0,0,4
AX2716,1,1,1,1,0,0,0,0,4
AX1866,0,0,0,0,0,0,0,0,0
AX1728,0,0,0,0,0,0,0,0,0
AX1742,0,1,0,0,0,0,0,0,1
AX1344,0,1,1,1,0,1,0,0,4
AX2417,0,0,0,0,0,0,0,0,0
AX2454,0,0,1,1,0,0,0,0,2
AX2445,0,1,0,0,0,0,0,0,1
AX7148,0,0,0,0,0,0,0,0,0
AX5264,0,0,0,0,0,0,0,0,0
AX5584,0,1,0,0,0,0,0,0,1
AX7133SET,0,0,0,0,0,0,0,0,0
AX1950,0,1,0,0,0,0,0,0,1
AX7147,0,1,1,1,0,1,0,0,4
AX1443,0,0,0,0,0,0,0,0,0
AX1867,0,1,1,1,0,1,0,0,4
AX1736,0,0,0,0,0,0,0,0,0
AX5385,0,1,1,1,0,1,0,0,4
AX7151SET,0,1,0,1,0,1,0,0,3
AX5256,0,0,0,0,0,0,0,0,0
AR11339,0,0,0,0,0,0,0,0,0
AR11006,0,0,0,0,0,0,0,0,0
AR11143,0,0,0,0,0,0,0,0,0
AR11560I,0,0,0,0,0,0,0,0,0
AR11453,0,0,0,0,0,0,0,0,0
AR11129,0,0,0,0,0,0,0,0,0
AR11560,0,1,0,1,0,1,0,0,3
AR11360,0,1,0,1,0,1,0,0,3
AR11363,0,0,0,0,0,0,0,0,0
AR11396,0,1,0,0,0,0,0,0,1
AR11421,0,0,0,1,0,0,0,0,1
AR11446,0,2,0,0,0,1,0,0,3
AR11223,0,0,0,1,0,0,0,0,1
AR11409,0,0,1,1,0,0,0,0,2
AR11524,0,1,1,1,0,0,0,0,3
AR11500,0,1,1,1,0,1,0,0,4
AR11244,0,1,1,1,0,0,0,0,3
AR11152,0,0,0,0,0,0,0,0,0
AR1926,0,1,1,1,0,1,0,0,4
AR11509,0,0,0,0,0,0,0,0,0
AR1828,0,1,1,1,0,1,0,0,4
AR11451,0,0,0,0,0,0,0,0,0
AR11578,0,0,1,1,0,1,0,0,3
AR11481,0,0,0,1,0,1,0,0,2
AR11351,0,0,1,0,0,0,0,0,1
AR11181,0,1,0,0,0,1,0,0,2
AR1970,0,1,0,1,0,1,0,0,3
AR11553,0,1,0,0,0,0,0,0,1
AR1979,0,1,1,1,0,1,0,0,4
AR2434,0,1,1,1,0,1,0,0,4
AR60037,0,1,0,0,0,0,0,0,1
AR1909,0,1,0,1,0,1,0,0,3
AR2448,0,1,1,1,0,0,0,0,3
AR11567,0,1,0,1,0,1,0,0,3
AR60008,0,1,0,1,0,0,0,0,2
AR11208,0,0,0,0,0,0,0,0,0
AR2502,3,1,1,1,0,1,0,0,7
AR2068,0,0,0,0,0,0,0,0,0
AR11445,0,1,0,1,0,0,0,0,2
AR11201,0,0,0,0,0,0,0,0,0
AR60042,0,0,0,0,0,0,0,0,0
AR11558,0,0,0,1,0,1,0,0,2
AR11523,0,1,1,1,0,0,0,0,3
AR11181I,0,0,0,0,0,0,0,0,0
AR11500I,0,0,0,0,0,0,0,0,0
AR11610,0,0,0,1,0,1,0,0,2
AR1853,0,0,0,1,0,1,0,0,2
AR11572,0,0,1,1,0,0,0,0,2
AR11499,0,1,0,1,0,1,0,0,3
AR11556,0,1,0,1,0,2,0,0,4
AR70007,0,1,0,0,0,0,0,0,1
AR11569,0,0,1,1,0,1,0,0,3
AR11582,0,0,1,1,0,1,0,0,3
AR6060,0,1,0,0,0,0,0,0,1
AR11527,0,0,0,0,0,0,0,0,0
AR11428,0,0,0,1,0,0,0,0,1
AR11164,0,0,0,0,0,0,0,0,0
AR11105,0,0,0,0,0,0,0,0,0
AR1895,0,0,0,0,0,0,0,0,0
AR6061,0,1,0,0,0,0,0,0,1
AR11402,0,0,0,0,0,0,0,0,0
AR60032,0,0,0,0,0,0,0,0,0
AR11429,0,0,0,0,0,0,0,0,0
AR60056,0,0,0,0,0,0,0,0,0
AR60049,0,0,0,0,0,0,0,0,0
AR60045,0,0,0,0,0,0,0,0,0
AR11583,0,1,0,1,0,1,0,0,3
AR11576,0,1,1,1,0,2,0,0,5
AR11600,0,0,1,1,0,1,0,0,3
AR11431,0,0,0,0,0,0,0,0,0
AR2447,0,1,1,0,0,1,0,0,3
AR11605,0,1,1,1,0,1,0,0,4
AR11571,0,0,0,1,0,1,0,0,2
AR11182,0,0,0,0,0,0,0,0,0
AR11180,0,0,0,0,0,0,0,0,0
AR11591,0,1,0,1,0,1,0,0,3
ART5027,0,1,0,0,0,0,0,0,1
AR11541,0,1,0,1,0,1,0,0,3
AR11484,0,1,1,1,0,0,0,0,3
AR11537,0,1,0,1,0,1,0,0,3
AR70008,0,0,0,1,0,1,0,0,2
AR11530,0,1,1,1,0,1,0,0,4
AR11520,0,0,0,0,0,0,0,0,0
AR11579,0,0,0,0,0,1,0,0,1
AR11562,0,1,1,1,0,1,0,0,4
AR11511,0,0,0,0,0,1,0,0,1
AR11529,0,1,1,1,0,1,0,0,4
AR70002,0,0,0,0,0,0,0,0,0
AR11450,0,0,0,0,0,0,0,0,0
AR11227,0,0,0,0,0,0,0,0,0
AR11568,0,1,0,1,0,0,0,0,2
AR11398,0,0,0,0,0,0,0,0,0
AR11423,0,0,0,0,0,0,0,0,0
AR11410,0,0,0,0,0,0,0,0,0
AR11521,0,0,0,1,0,1,0,0,2
AR11561,0,0,0,0,0,0,0,0,0
ART5029,0,1,0,0,0,0,0,0,1
AR11528,0,0,1,0,0,1,0,0,2
AR11588,0,0,0,0,0,0,0,0,0
AR1908,0,1,0,1,0,0,0,0,2
AR11566,0,0,0,0,0,0,0,0,0
AR11338,0,1,1,1,0,0,0,0,3
AR11606,0,0,0,1,0,1,0,0,2
AR11608,0,1,1,2,0,1,0,0,5
AR11589,0,1,0,0,0,1,0,0,2
AR11587,0,1,0,0,0,1,0,0,2
AR11362,0,1,0,0,0,1,0,0,2
AR11059,0,0,0,0,0,0,0,0,0
AR11392,0,1,0,0,0,0,0,0,1
AR11362I,0,0,0,0,0,0,0,0,0
AR60061,0,0,0,0,0,0,0,0,0
AR11188,0,0,0,1,0,1,0,0,2
AR11243,0,0,0,1,0,0,0,0,1
AR11581,0,1,1,1,0,1,0,0,4
AR2482,0,0,0,1,0,1,0,0,2
AR60007,0,1,0,1,0,1,0,0,3
AR60044,0,0,0,0,0,0,0,0,0
AR11161,0,0,0,0,0,0,0,0,0
AR11007,0,0,0,0,0,0,0,0,0
AR60023,0,0,1,0,0,0,0,0,1
AR11597,0,0,0,0,0,0,0,0,0
AR11306,0,0,0,0,0,0,0,0,0
AR1968,0,0,0,0,0,0,0,0,0
AR70010,0,1,0,0,0,1,0,0,2
AR11573,0,1,1,1,0,1,0,0,4
AR1840,0,0,1,1,0,0,0,0,2
AR11507,0,1,0,1,0,1,0,0,3
AR60075,0,1,0,0,0,0,0,0,1
AR11554,0,1,1,1,0,1,0,0,4
AR11449,0,0,0,0,0,0,0,0,0
AR60053,0,0,0,1,0,1,0,0,2
AR1925,0,1,0,1,0,1,0,0,3
AR2500,0,0,0,1,0,1,0,0,2
AR1676,0,1,1,1,0,1,0,0,4
AR11091,0,0,0,0,0,0,0,0,0
AR11601,0,0,0,1,0,1,0,0,2
AR11609,0,1,1,1,0,0,0,0,3
AR70006,0,0,0,0,0,0,0,0,0
AR11575,0,0,1,1,0,1,0,0,3
AR11599,0,1,0,1,0,1,0,0,3
AR11512,0,0,0,0,0,0,0,0,0
CE1112,0,2,0,0,0,0,0,0,2
CE1114,0,0,0,0,0,0,0,0,0
CE1121,0,0,0,0,0,0,0,0,0
ES3284,2,1,1,1,0,0,0,0,5
CE5027,0,1,1,1,0,0,0,0,3
CE1108,0,0,0,0,0,1,0,0,1
CE1111,0,1,0,0,0,0,0,0,1
CE1107,0,0,1,0,0,0,0,0,1
ES2811,2,1,1,1,0,1,0,0,6
CE5029,0,1,0,0,0,0,0,0,1
ES3405,0,0,0,0,0,0,0,0,0
ES4319,0,0,0,0,0,0,0,0,0
ES4447,0,0,0,0,0,0,0,0,0
ES3546,0,1,0,1,0,0,0,0,2
ES5087,0,0,1,0,0,0,0,0,1
ES4274,0,0,1,0,0,0,0,0,1
ES4433,0,0,0,0,0,0,0,0,0
ES4628,0,0,0,1,0,0,0,0,1
ES3716,0,0,0,0,0,1,0,0,1
ES4746,0,1,0,1,0,1,0,0,3
ES4519,0,1,0,1,0,0,0,0,2
ES5070,0,0,0,0,0,0,0,0,0
ES3545,2,1,1,1,0,1,0,0,6
ES5109,0,0,0,0,0,0,0,0,0
ES4318,0,0,0,0,0,0,0,0,0
ES5098,0,1,0,0,0,1,0,0,2
ES4745,0,1,1,0,0,0,0,0,2
ES5218,0,0,0,0,0,0,0,0,0
FS4552,2,1,1,1,0,1,0,0,6
FS4812,0,1,1,1,0,1,0,0,4
ES5216,1,1,1,1,0,1,0,0,5
ES5131,0,1,1,0,0,0,0,0,2
ES5198,0,0,0,0,0,0,0,0,0
ES5165,0,0,0,1,0,0,0,0,1
FS5447,0,2,0,0,0,1,0,0,3
FS4735,2,1,1,1,0,1,0,0,6
FS4682,2,1,1,1,0,1,0,0,6
ES5159,0,0,0,0,0,0,0,0,0
FS4813,0,1,1,1,0,1,0,0,4
FS4795,0,0,0,0,0,0,0,0,0
FS5437,0,1,1,1,0,1,0,0,4
FS5305,0,1,1,0,0,1,0,0,3
FS4835,3,1,1,1,0,1,0,0,7
FS5061,2,1,1,1,0,1,0,0,6
FS5402,0,0,0,0,0,0,0,0,0
FS5907,0,0,0,0,0,0,0,0,0
FS5453,0,0,0,0,0,0,0,0,0
ES4301,0,0,0,1,0,1,0,0,2
ES5106,0,0,1,0,0,0,0,0,1
ME3098,0,0,1,1,0,0,0,0,2
ME3061,0,1,1,1,0,1,0,0,4
FS5308,0,1,1,1,0,1,0,0,4
FS5512,1,1,1,1,0,1,0,0,5
FS5459,0,1,1,0,0,1,0,0,3
ME3155,0,1,1,1,0,1,0,0,4
ME3110,1,1,1,1,0,1,0,0,5
ME3185,0,0,1,0,0,0,0,0,1
ME3172,0,1,1,1,0,0,0,0,3
ME3197,0,1,0,1,0,0,0,0,2
ME3170,0,1,1,1,0,1,0,0,4
FS5763,0,0,0,0,0,0,0,0,0
ME3183,0,0,1,1,0,0,0,0,2
FS5551,0,1,1,0,0,0,0,0,2
FS5503,0,0,0,0,0,0,0,0,0
FS5792,0,0,1,1,0,0,0,0,2
FS5525,1,1,1,2,0,1,0,0,6
ME3210,0,1,0,1,0,0,0,0,2
ME3218,0,0,0,0,0,0,0,0,0
FS5699,1,1,1,1,0,1,0,0,5
FS5900,0,3,0,0,0,0,0,0,3
FS5384,0,0,0,0,0,0,0,0,0
FS5607,0,0,0,0,0,0,0,0,0
FS5841,0,0,0,0,0,0,0,0,0
FS5896,0,1,0,0,0,0,0,0,1
FS6017,0,1,2,0,0,0,0,0,3
FS5796,0,0,0,0,0,0,0,0,0
FS5852,0,0,0,0,0,0,0,0,0
FTW4055,0,1,1,0,0,0,0,0,2
FS5862,0,1,0,0,0,0,0,0,1
FS5905,0,1,1,0,0,0,0,0,2
FS6034,1,1,1,1,0,1,0,0,5
ME3099,0,1,1,1,0,0,0,0,3
FS5906,0,1,1,1,0,1,0,0,4
FS6016,0,0,0,0,0,0,0,0,0
FS5903,0,0,0,0,0,0,0,0,0
FTW4033,0,1,1,0,0,0,0,0,2
ES5324,0,0,0,1,0,0,0,0,1
FTW4063,0,1,1,0,0,0,0,0,2
FTW6078,0,1,0,1,0,0,0,0,2
ME3219,0,0,0,0,0,0,0,0,0
FS5380,1,1,1,1,0,1,0,0,5
FTW6036,0,0,0,0,0,0,0,0,0
FTW4025,0,1,1,1,0,1,0,0,4
FTW6077,0,0,0,0,0,0,0,0,0
BQ2551,0,0,0,0,0,0,0,0,0
FTW4059,0,1,0,1,0,1,0,0,3
BQ2328,0,0,0,0,0,0,0,0,0
FTW4062,0,1,1,1,0,0,0,0,3
BQ2366,3,1,1,1,0,1,0,0,7
FTW7010,0,0,0,0,0,1,0,0,1
FTW4060,0,2,1,1,0,0,0,0,4
FS5946,0,1,1,1,0,1,0,0,4
BQ2492,0,0,0,0,0,0,0,0,0
ES5267,0,1,1,0,0,0,0,0,2
FTW6079,0,1,1,1,0,0,0,0,3
FS6016I,0,0,0,0,0,0,0,0,0
ES5136,0,0,0,0,0,0,0,0,0
ES5217,0,1,0,1,0,0,0,0,2
FTW7017,0,0,1,0,0,0,0,0,1
ME3206,0,0,0,0,0,0,0,0,0
FS5305I,0,0,0,0,0,0,0,0,0
ES5217I,0,0,0,0,0,0,0,0,0
ES5275,0,1,0,0,0,0,0,0,1
BQ1571,0,1,0,1,0,1,0,0,3
FS5798,0,0,0,0,0,1,0,0,1
BQ3656,0,0,0,0,0,0,0,0,0
BQ2365,0,0,0,0,0,1,0,0,1
BQ2552,0,0,0,0,0,0,0,0,0
BQ2401,0,0,0,1,0,0,0,0,1
ES4735,0,0,0,0,0,0,0,0,0
BQ3377,0,1,1,1,0,1,0,0,4
BQ2453,0,0,0,0,0,0,0,0,0
BQ2512,0,0,0,0,0,0,0,0,0
ES5300,0,1,1,1,0,0,0,0,3
BQ2491,0,1,0,0,0,0,0,0,1
ES5269,0,1,0,0,0,0,0,0,1
BQ3691,0,1,1,1,0,1,0,0,4
BQ3036,0,0,0,0,0,0,0,0,0
ES5258,0,1,1,1,0,1,0,0,4
ES5259,0,1,1,1,0,1,0,0,4
BQ3729,0,1,0,0,0,0,0,0,1
ES5286,0,0,0,0,0,0,0,0,0
ES5245,0,1,2,1,0,1,0,0,5
ES4649,0,1,1,1,0,0,0,0,3
ES5068,0,0,0,0,0,0,0,0,0
BQ3639,0,1,1,1,0,1,0,0,4
FS5983,0,0,0,0,0,1,0,0,1
CE1110,0,2,1,0,0,0,0,0,3
ES5319,0,1,1,1,0,0,0,0,3
FS5990,0,1,1,1,0,1,0,0,4
FS6035,0,1,1,1,0,1,0,0,4
ES5219,0,1,1,0,0,0,0,0,2
FS5963,3,1,1,1,0,1,0,0,7
BQ2401N,0,0,1,0,0,0,0,0,1
BQ2494,0,1,0,1,0,0,0,0,2
CE1110I,0,0,0,0,0,0,0,0,0
ES5329,0,1,0,0,0,0,0,0,1
BQ2412,0,0,0,1,0,2,0,0,3
ES5320,0,0,1,0,0,0,0,0,1
FS6045,0,1,0,1,0,0,0,0,2
FTW2109,0,1,0,0,0,0,0,0,1
FS5901,0,1,1,1,0,0,0,0,3
ES5317,0,0,0,0,0,0,0,0,0
ES3020,0,1,1,1,0,1,0,0,4
FS6032,0,1,1,1,0,0,0,0,3
ES5337,0,1,0,0,0,0,0,0,1
FS5992,0,0,0,0,0,0,0,0,0
FS5522,0,1,1,1,0,1,0,0,4
FTW4069,0,1,0,0,0,0,0,0,1
ES5345,0,0,0,1,0,0,0,0,1
ES5300I,0,0,0,0,0,0,0,0,0
ES5350,0,1,0,1,0,0,0,0,2
FS6029,0,1,0,0,0,0,0,0,1
ES5338,0,1,0,1,0,0,0,0,2
FS4867,0,0,0,0,0,0,0,0,0
BQ3392,0,0,0,1,0,0,0,0,1
FTW4047,0,0,0,0,0,0,0,0,0
FS6031,1,1,1,1,0,1,0,0,5
BQ3721,0,0,1,1,0,0,0,0,2
ES5349,0,1,1,1,0,0,0,0,3
BQ2457,0,0,0,0,0,0,0,0,0
FTW4071,0,0,0,0,0,0,0,0,0
CE1125,0,0,0,0,0,0,0,0,0
FS6027,0,0,0,0,0,0,0,0,0
ES5341,0,1,0,0,0,0,0,0,1
BQ2366N,0,0,0,0,0,0,0,0,0
FTW2109D,0,0,0,0,0,0,0,0,0
FS5851,0,1,0,1,0,0,0,0,2
FTW4051,0,0,0,0,0,0,0,0,0
FS6017I,0,0,0,0,0,0,0,0,0
FS5900I,0,0,0,0,0,0,0,0,0
FS6013,0,1,0,1,0,1,0,0,3
FTW1106,0,0,0,0,0,1,0,0,1
FS5972,0,1,0,1,0,0,0,0,2
ES5259I,0,0,0,0,0,0,0,0,0
FS6042,0,1,1,0,0,0,0,0,2
FS6050,0,1,0,0,0,0,0,0,1
FS6033,0,0,1,1,0,0,0,0,2
FTW2112,0,1,0,0,0,0,0,0,1
BQ2383,0,0,0,0,0,0,0,0,0
BQ2541,0,0,0,1,0,0,0,0,1
BQ2493,2,1,1,1,0,1,0,0,6
FTW4056,0,0,0,0,0,0,0,0,0
ES5261,0,0,0,0,0,1,0,0,1
BQ2386,0,0,0,0,0,0,0,0,0
ES5344,0,1,1,0,0,0,0,0,2
FS6030,0,1,1,1,0,0,0,0,3
FS4736,0,1,0,0,0,0,0,0,1
FS6026,0,0,0,0,0,0,0,0,0
FTW6073,0,0,0,0,0,0,0,0,0
ES5322,0,0,0,0,0,0,0,0,0
ES5343,0,0,0,1,0,0,0,0,1
FS4656,0,0,0,0,0,0,0,0,0
ES5330,0,1,0,0,0,0,0,0,1
FS6048,0,1,1,1,0,0,0,0,3
FS4487,0,1,0,1,0,1,0,0,3
FTW7045,0,0,0,0,0,0,0,0,0
CE5028,0,0,0,0,0,1,0,0,1
FTW2102,0,1,1,0,0,0,0,0,2
ES4748,0,0,0,0,0,0,0,0,0
FS5949,0,0,0,0,0,0,0,0,0
BQ3393,0,0,0,1,0,1,0,0,2
FS5251,0,1,0,0,0,0,0,0,1
FS6028,0,0,0,0,0,1,0,0,1
ME3171,2,1,1,1,0,1,0,0,6
BQ3341,0,1,1,1,0,0,0,0,3
FTW4000,0,1,0,0,0,0,0,0,1
ES4342,0,0,0,0,0,0,0,0,0
ES5334,0,1,0,2,0,1,0,0,4
CE1123,0,0,0,0,0,1,0,0,1
ME3171I,0,0,0,0,0,0,0,0,0
FTW6054,0,0,0,0,0,0,0,0,0
FS5452,0,0,1,0,0,0,0,0,1
ES5279,0,1,1,1,0,1,0,0,4
BQ3420,0,0,0,0,0,0,0,0,0
FTW6080,0,1,1,0,0,0,0,0,2
ES5293,0,0,0,0,0,0,0,0,0
ME3195,0,0,0,0,0,1,0,0,1
FTW4019,0,0,0,0,0,0,0,0,0
ME3217,0,1,0,1,0,0,0,0,2
ES5277,0,1,0,0,0,1,0,0,2
ES5246,0,0,1,1,0,0,0,0,2
FTW4061,0,0,0,0,0,0,0,0,0
FTW6068,0,0,0,0,0,0,0,0,0
FTW4049,0,0,0,0,0,0,0,0,0
BQ3378,1,1,1,1,0,1,0,0,5
BQ3281,0,0,0,0,0,0,0,0,0
BQ3568,0,0,0,0,0,0,0,0,0
ME3230,0,0,0,0,0,0,0,0,0
ES5247,0,1,2,2,0,0,0,0,5
ES5299,1,2,1,1,0,1,0,0,6
ES5299I,0,0,0,0,0,0,0,0,0
FTW4024,0,0,0,0,0,0,0,0,0
FTW6024,0,1,0,0,0,0,0,0,1
FTW4040,0,0,0,0,0,0,0,0,0
ES5321,0,1,1,1,0,1,0,0,4
ES3282,0,0,0,0,0,0,0,0,0
ME3232,0,1,0,0,0,0,0,0,1
BQ2419,0,1,0,0,0,1,0,0,2
FS6047,0,1,0,0,0,0,0,0,1
ES2362,0,0,0,0,0,0,0,0,0
ME3207,0,0,0,0,0,0,0,0,0
FS5151,0,0,0,0,0,0,0,0,0
FS6014,0,0,1,0,0,0,0,0,1
ES5348,0,1,0,1,0,1,0,0,3
MK3640,0,0,0,0,0,0,0,0,0
MK3845,0,1,0,0,0,1,0,0,2
MK3716,0,1,1,0,0,0,0,0,2
MK4594,0,0,0,0,0,0,0,0,0
MK3513,0,1,1,1,0,1,0,0,4
MK5263,0,1,0,1,0,1,0,0,3
MK4598,0,0,0,0,0,1,0,0,1
MK4335,0,0,0,0,0,0,0,0,0
MK5799,0,1,0,0,0,1,0,0,2
MK4593,0,1,0,1,0,1,0,0,3
MK6301,0,0,0,0,0,0,0,0,0
MK5896,0,0,1,1,0,0,0,0,2
MK7279,0,1,0,0,0,0,0,0,1
MK9055,0,0,0,0,0,0,0,0,0
MK7302,0,1,0,0,0,0,0,0,1
MKT5072,0,1,1,0,0,0,0,0,2
MK8603,0,0,0,0,0,0,0,0,0
MK5798,0,1,1,1,0,1,0,0,4
MK5491,0,1,1,1,0,1,0,0,4
MKT5129,0,0,0,0,0,0,0,0,0
MK4519,0,0,0,0,0,1,0,0,1
MKT5096,0,1,0,0,0,0,0,0,1
MK6937,0,1,0,0,0,0,0,0,1
MK7076,0,1,1,0,0,0,0,0,2
MKT5135,0,0,0,0,0,0,0,0,0
MK6988,0,0,0,1,0,0,0,0,1
MKT5138,0,0,0,0,0,0,0,0,0
MK2834,0,0,0,0,0,0,0,0,0
MK7230,0,0,0,0,0,0,0,0,0
MKT5144,0,0,0,0,0,0,0,0,0
MK6989,0,1,1,0,0,0,0,0,2
MKT5139,0,1,0,1,0,0,0,0,2
MKT5137,0,0,0,0,0,0,0,0,0
MKT5150,0,0,0,0,0,0,0,0,0
MK7229,0,1,1,0,0,1,0,0,3
MKT5134,0,0,0,0,0,0,0,0,0
MK3892,0,1,0,0,0,0,0,0,1
MK3192,0,0,0,1,0,1,0,0,2
MK3979,0,0,0,1,0,1,0,0,2
MK4557,0,0,0,0,0,0,0,0,0
MK4336,0,0,0,0,0,0,0,0,0
MK4731,0,0,0,0,0,0,0,0,0
MK4709,0,1,1,1,0,1,0,0,4
MK4667,0,0,0,1,0,1,0,0,2
MK3298,0,1,0,0,0,1,0,0,2
MK4708,0,1,0,0,0,0,0,0,1
MK6485,0,1,0,1,0,1,0,0,3
MK4733,0,1,0,0,0,0,0,0,1
MK4732,0,1,1,1,0,1,0,0,4
MK4710,0,1,0,1,0,2,0,0,4
MK4736,0,0,0,0,0,1,0,0,1
MK4739,0,0,0,0,0,0,0,0,0
MK7209,0,0,0,0,0,0,0,0,0
MK4734,0,1,0,1,0,1,0,0,3
MKT5136,0,0,0,0,0,0,0,0,0
MK7355,0,1,1,1,0,0,0,0,3
MK5503,0,1,0,0,0,1,0,0,2
MK7449,0,0,0,0,0,0,0,0,0
MK6694,0,0,0,0,0,0,0,0,0
MK7323,0,1,0,0,0,0,0,0,1
MKT5135V,0,0,0,0,0,0,0,0,0
MK5354,0,1,0,1,0,1,0,0,3
MK7338,0,1,0,0,0,1,0,0,2
MK6910,0,0,0,0,0,0,0,0,0
MK5976,0,0,0,0,0,0,0,0,0
MK7219,0,0,0,0,0,0,0,0,0
MK5739,0,0,0,0,0,0,0,0,0
MK6846,0,0,0,0,0,1,0,0,1
MK7327,0,0,1,0,0,0,0,0,1
MK7310,0,1,0,0,0,0,0,0,1
MK7257,0,0,0,0,0,0,0,0,0
MK7242,0,0,0,0,0,0,0,0,0
MK6971,0,0,0,0,0,0,0,0,0
MK7275,0,0,0,0,0,0,0,0,0
MK7328,0,1,1,0,0,0,0,0,2
MK7332,0,1,0,0,0,0,0,0,1
MK7283,0,0,0,0,0,1,0,0,1
MK4666,0,0,0,1,0,0,0,0,1
MK7358,0,1,0,0,0,1,0,0,2
MK7357,0,1,0,0,0,0,0,0,1
MK7361,0,0,0,0,0,0,0,0,0
MK6959,0,1,0,0,0,0,0,0,1
MK7353,0,0,0,0,0,0,0,0,0
MK7378,0,0,0,0,0,0,0,0,0
MK7453,0,0,0,0,0,0,0,0,0
MK8734,0,0,0,0,0,0,0,0,0
MK7336,0,0,0,0,0,0,0,0,0
MK7452,0,1,0,0,0,0,0,0,1
MK7324,0,0,1,0,0,0,0,0,1
MK9140,0,0,0,0,0,0,0,0,0
MK7392,0,1,0,0,0,0,0,0,1
MK7334,0,0,0,0,0,1,0,0,1
MKT5077,0,0,1,0,0,0,0,0,1
MK9149,0,0,0,1,0,1,0,0,2
MK8938,0,0,0,0,0,0,0,0,0
MKT5148,0,0,0,1,0,0,0,0,1
MK7467,0,1,0,0,0,0,0,0,1
MK7422,0,1,0,0,0,0,0,0,1
MK7481,0,0,0,1,0,1,0,0,2
MK4811,0,1,1,1,0,0,0,0,3
MK9118,0,0,0,0,0,0,0,0,0
MK9111I,0,0,0,0,0,0,0,0,0
MK6451,0,1,0,0,0,0,0,0,1
MK7462,0,1,0,1,0,0,0,0,2
MK7460,0,0,0,1,0,0,0,0,1
MK8494,0,0,0,0,0,0,0,0,0
MK7405,0,0,1,0,0,0,0,0,1
MK9111,0,1,0,1,0,1,0,0,3
MK4806,0,0,0,1,0,0,0,0,1
MK7472,0,1,0,1,0,0,0,0,2
MK7362,0,1,1,1,0,0,0,0,3
MK9112,0,1,1,1,0,0,0,0,3
MK7405I,0,0,0,0,0,0,0,0,0
MK3900,0,0,0,1,0,0,0,0,1
MK8987,0,1,1,1,0,0,0,0,3
MK7293,0,1,1,0,0,0,0,0,2
MK4741,0,1,0,1,0,0,0,0,2
MK7402,0,1,1,1,0,0,0,0,3
MKT5146,0,0,0,0,0,0,0,0,0
MK7397I,0,0,0,0,0,0,0,0,0
MK7402I,0,0,0,0,0,0,0,0,0
MK9113,0,0,1,1,0,1,0,0,3
MK9113I,0,0,0,0,0,0,0,0,0
MK8279,0,1,0,1,0,0,0,0,2
MK7285,0,0,0,0,0,0,0,0,0
MK7352,0,0,1,0,0,0,0,0,1
MK8655,0,1,1,1,0,0,0,0,3
MK9074,0,0,0,0,0,0,0,0,0
Mk8625,0,1,1,0,0,0,0,0,2
MK7397,0,0,1,0,0,0,0,0,1
MK7217,0,0,0,0,0,0,0,0,0
MK7363,0,1,0,0,0,0,0,0,1
MK8848,0,0,0,0,0,0,0,0,0
MK6674,0,0,0,0,0,0,0,0,0
MK9075,0,0,0,1,0,0,0,0,1
MK9146,0,0,0,0,0,0,0,0,0
MK7444,0,0,0,0,0,0,0,0,0
MK9147,0,0,1,1,0,1,0,0,3
MK4810,0,0,0,0,0,1,0,0,1
MK7430,0,0,0,0,0,0,0,0,0
MK7297,0,1,0,0,0,0,0,0,1
MK9057,0,0,0,1,0,0,0,0,1
MK9019,0,0,0,0,0,0,0,0,0
MK8953,0,0,0,0,0,1,0,0,1
MK7218,0,1,0,1,0,0,0,0,2
MK7458,0,0,0,1,0,0,0,0,1
MK7469,0,1,0,0,0,0,0,0,1
MK7403I,0,0,0,0,0,0,0,0,0
MK7364,0,1,0,0,0,0,0,0,1
MK7465,0,1,0,0,0,0,0,0,1
MK8561,0,0,0,0,0,0,0,0,0
MK7457,0,1,0,0,0,0,0,0,1
MK7403,0,1,0,0,0,0,0,0,1
MK7286,0,1,1,0,0,0,0,0,2
MK9153,0,1,0,1,0,0,0,0,2
MK7435,0,0,0,0,0,1,0,0,1
MK4735,0,1,1,1,0,1,0,0,4
MK9162,0,0,0,0,0,0,0,0,0
MK8849,0,0,0,0,0,0,0,0,0
MK7473,0,0,0,1,0,0,0,0,1
MK7371,0,1,1,1,0,1,0,0,4
MK9136,0,1,1,1,0,1,0,0,4
MK9073,0,1,0,1,0,0,0,0,2
MK8325,0,0,1,1,0,1,0,0,3
MK4711,0,0,0,1,0,0,0,0,1
MK7354,0,0,0,0,0,0,0,0,0
MK7386,0,0,0,0,0,0,0,0,0
MK9134,0,1,1,1,0,1,0,0,4
MK7212,0,0,0,0,0,0,0,0,0
MK8984,0,0,0,0,0,0,0,0,0
MK3203,0,1,0,1,0,1,0,0,3
MK4340,0,1,1,1,0,0,0,0,3
MK8344,0,0,1,1,0,0,0,0,2
MK8278,0,0,0,1,0,0,0,0,1
MK3253,0,0,1,0,0,0,0,0,1
MKT5153,0,0,1,0,0,0,0,0,1
MKT5133,1,0,1,1,0,1,0,0,4
MK3839,0,0,0,0,0,0,0,0,0
MK3190,0,0,0,1,0,1,0,0,2
MK7276,0,0,0,1,0,1,0,0,2
MK6357,1,1,1,1,0,1,0,0,5
MK7282,0,0,0,0,0,0,0,0,0
MK4737,0,0,0,0,0,1,0,0,1
MK6763,0,0,1,0,0,0,0,0,1
MK7270,0,0,0,0,0,0,0,0,0
MK4623,0,0,0,0,0,0,0,0,0
MK6110,0,1,0,1,0,0,0,0,2
MK7213,0,0,1,0,0,0,0,0,1
MK6845,0,0,0,1,0,1,0,0,2
MK7222,0,0,0,0,0,0,0,0,0
MK7303,1,2,1,1,0,1,0,0,6
MK7396,0,1,0,1,0,0,0,0,2
MK7442,0,0,0,0,0,1,0,0,1
MK9154,0,0,0,1,0,0,0,0,1
MK3639I,0,0,0,0,0,0,0,0,0
MK9152,0,0,1,1,0,1,0,0,3
MK5605,0,1,0,1,0,0,0,0,2
MK8979,0,0,0,0,0,0,0,0,0
MK3639,0,0,1,0,0,0,0,0,1
MK9046,0,0,0,0,0,0,0,0,0
MK7241,0,1,0,1,0,0,0,0,2
MK7406,0,0,0,0,0,0,0,0,0
MK6729,0,0,0,0,0,1,0,0,1
MK9166,0,0,0,1,0,0,0,0,1
MK4827,0,0,0,1,0,1,0,0,2
MK9119,0,0,0,0,0,0,0,0,0
MKT5080,0,0,0,0,0,0,0,0,0
MK8954,0,0,0,0,0,0,0,0,0
MK7428I,0,0,0,0,0,0,0,0,0
MK4801,0,0,0,1,0,0,0,0,1
MK7428,0,1,1,1,0,1,0,0,4
MK9165,0,0,0,0,0,0,0,0,0
MK9155,0,0,1,1,0,1,0,0,3
MKT5143,0,0,0,0,0,0,0,0,0
MK8286,0,0,1,1,0,0,0,0,2
MK4823,0,1,0,1,0,0,0,0,2
VE2U00622,0,0,0,1,0,0,0,0,1
V12040015,0,1,0,0,0,0,0,0,1
VECO03222,0,1,0,0,0,0,0,0,1
VEPM00420,0,1,0,0,0,0,0,0,1
VECO03122,0,0,0,1,0,0,0,0,1
VEBQ01719,0,0,0,1,0,0,0,0,1
VERE02420,0,1,0,0,0,0,0,0,1
VEZ300621,0,0,0,1,0,0,0,0,1
VERE02320,0,0,0,1,0,0,0,0,1
VEVK00720,0,0,0,1,0,0,0,0,1
VELV00620,0,0,0,1,0,0,0,0,1
VEZ400521,0,0,0,1,0,0,0,0,1
VEZ600421,0,0,0,1,0,0,0,0,1
VET300921,0,1,0,0,0,0,0,0,1
VE2W00322,0,1,0,0,0,0,0,0,1
VEZ200421,0,0,0,0,0,0,0,0,0
VE2W00622,0,0,0,1,0,0,0,0,1
V16060017,0,0,0,1,0,0,0,0,1
VEZ600321,0,0,0,1,0,0,0,0,1
VEZ200521,0,0,0,1,0,0,0,0,1
V12060017,0,1,0,0,0,0,0,0,1
VEPN00520,0,0,0,0,0,0,0,0,0
VE6H00723,0,0,0,0,0,0,0,0,0
VEVI00620,0,0,0,1,0,0,0,0,1
VEAA01420,0,1,0,0,0,0,0,0,1
VESN00922,0,1,0,0,0,0,0,0,1
VEVK00320,0,0,0,1,0,0,0,0,1
VESN00722,0,1,0,0,0,0,0,0,1
VERE02120,0,1,0,0,0,0,0,0,1
VEK400821,0,1,0,0,0,0,0,0,1
VEVK00420,0,0,0,1,0,0,0,0,1
VE2R00322,0,1,0,0,0,0,0,0,1
RC5L031M0105,0,0,0,0,0,0,0,0,0
JC1L224M0075,0,1,0,1,1,2,7,1,13
GW0265G12,0,1,1,1,1,0,10,1,15
GW0690L4,0,1,1,1,1,0,5,1,10
GWO613L3,0,0,0,0,0,0,0,0,0
GW0798G3,0,0,0,0,0,0,0,1,1
DW00100205,0,0,0,0,0,0,0,1,1
DW00100125,0,0,0,0,0,0,0,1,1
DW00100427,0,0,0,0,0,0,0,0,0
DW00100472,0,0,0,0,0,0,0,1,1
DW00100308,0,0,0,0,0,0,0,1,1
DW00100214,0,0,0,0,0,0,0,1,1
DW00100616,0,0,0,0,0,0,0,1,1
DW00100304,0,0,0,0,0,0,0,1,1
DW00100621,0,0,0,0,0,0,0,1,1
Z46002G9MF,0,0,0,1,1,0,1,0,3
Z50002G7MF,0,0,0,1,1,0,1,0,3
Y70009G5MF,0,0,0,1,1,0,0,0,2
DW00100448,0,0,0,0,0,0,0,1,1
DW00100438,0,0,0,0,0,0,0,1,1
DW00100006,0,0,0,1,0,0,1,1,3
JC1L301M0035,0,0,0,0,1,0,0,0,1
JC1L301M0065,0,0,0,0,1,1,2,1,5
JC1L301M0025,0,0,0,0,1,0,1,1,3
JC1L303M0055,0,0,0,1,1,1,13,1,17
JC1L301M0075,0,0,0,0,1,1,2,1,5
JC1L303M0035,0,0,0,0,1,0,3,1,5
JC1L303M0025,0,0,0,1,1,1,12,1,16
JC1L301M0055,0,0,0,0,1,0,0,1,2
JC1L301M0045,0,0,0,0,1,0,0,1,2
JC1L303M0065,0,0,0,1,1,1,12,1,16
JC1L303M0045,0,0,0,1,1,1,11,1,15
JC1L323M0065,0,0,0,1,1,1,11,1,15
JC1L321L0025,0,0,0,1,1,1,14,1,18
JC1L321L0035,0,0,0,1,1,1,12,1,16
JC1L323M0035,0,0,0,1,1,1,19,1,23
JC1L323M0055,0,0,0,0,1,1,11,1,14
JC1L321L0045,0,0,0,1,1,1,13,1,17
JC1L321L0065,0,0,0,1,1,1,14,1,18
JC1L322M0055,0,0,0,1,1,1,9,1,13
JC1L321L0015,0,0,0,1,1,1,12,1,16
JC1L322M0035,0,0,0,0,1,1,8,1,11
JC1L321L0055,0,0,0,1,1,1,12,1,16
AX4180,0,1,0,1,0,0,0,0,2
AX1422,0,1,0,1,0,1,0,0,3
AX1421,0,1,0,1,0,1,0,0,3
AX7147SET,0,1,1,1,0,1,0,0,4
AX4182,0,0,0,1,0,1,0,0,2
AX7160SET,0,1,0,1,0,0,0,0,2
AX5173,0,1,0,1,0,1,0,0,3
AX2458,0,1,0,1,0,1,0,0,3
AX1765,0,1,1,1,0,1,0,0,4
AX1963,0,1,1,1,0,1,0,0,4
AX2456,0,1,0,1,0,1,0,0,3
AR11615,0,1,0,0,0,1,0,0,2
AR60079,0,1,0,1,0,1,0,0,3
AR11627,0,1,0,1,0,1,0,0,3
AR60080,0,1,0,1,0,1,0,0,3
AR11628,0,1,0,0,0,0,0,0,1
AR11590,0,1,0,1,0,1,0,0,3
AR11634,0,1,0,0,0,1,0,0,2
AR11622,0,1,0,0,0,1,0,0,2
AR60078,0,1,0,1,0,1,0,0,3
AR1918,0,1,0,1,0,1,0,0,3
AR11620,0,1,0,0,0,1,0,0,2
AR11613,0,1,0,1,0,1,0,0,3
AR80023,0,1,0,0,0,1,0,0,2
AR11621,0,1,0,0,0,1,0,0,2
AR11242,0,1,0,0,0,1,0,0,2
VE6K00523,0,0,0,0,0,1,0,0,1
FS5251SET,0,1,0,0,0,1,0,0,2
ES5369,0,0,1,1,0,1,0,0,3
ES5308,1,1,1,0,0,1,0,0,4
MK8607,0,1,0,0,0,1,0,0,2
MK4841,0,1,0,1,0,1,0,0,3
MK4832,0,1,0,0,0,1,0,0,2
MKO1075,0,1,0,1,0,1,0,0,3
MK7505,0,0,0,0,0,1,0,0,1
MK4840,0,0,0,1,0,1,0,0,2
MK7496,0,1,1,1,0,0,0,0,3
MK7504,0,1,0,1,0,1,0,0,3
MK7503SET,0,1,0,1,0,0,0,0,2
MK4842,0,1,1,0,0,1,0,0,3
JC1L230M0065,0,1,0,1,1,1,51,1,56
JC1L303M0015,0,0,0,0,1,1,1,1,4
JC1L322M0015,0,0,0,0,1,0,0,1,2
JC1L323M0045,0,0,0,1,1,1,10,1,14
JC1L323M0025,0,0,0,0,0,1,8,1,10
JC1L323M0015,0,0,0,1,1,1,1,1,5
JC1L322M0025,0,0,0,1,1,1,21,1,25
JC1L322M0045,0,0,0,0,1,0,8,0,9
JC1L322M0065,0,0,0,1,1,1,15,1,19
AR11594,0,0,0,0,0,1,0,0,1
AR11559,0,0,0,1,0,1,0,0,2
VE8Q00524,0,0,0,0,0,1,0,0,1
VE7F00423,0,0,0,0,0,1,0,0,1
VEVK00520,0,0,0,0,0,0,0,0,0
VE8Q00424,0,0,0,0,0,1,0,0,1
VE7G00423,0,0,0,0,0,1,0,0,1
VE7F00523,0,0,0,0,0,1,0,0,1
VE7B00323,0,0,0,0,0,1,0,0,1
VE7E00423,0,0,0,0,0,1,0,0,1
VEU300421,0,0,0,0,0,0,0,0,0
VE8G00424,0,0,0,0,0,1,0,0,1
VE3I00422,0,0,0,0,0,0,0,0,0
VE9CA0324,0,0,0,0,0,1,0,0,1
VEZ600723,0,0,0,0,0,1,0,0,1
VE9CA0224,0,0,0,0,0,1,0,0,1
VE2U00522,0,0,0,0,0,1,0,0,1
VE1D02023,0,0,0,0,0,1,0,0,1
VE2CA0723,0,0,0,0,0,1,0,0,1
VE2S00422,0,0,0,0,0,1,0,0,1
VE8D00424,0,0,0,0,0,1,0,0,1
VE7G00223,0,0,0,0,0,1,0,0,1
VE8F00324,0,0,0,0,0,1,0,0,1
VEOCA0324,0,0,0,0,0,1,0,0,1
VE8I00624,0,0,0,0,0,1,0,0,1
VEVI00420,0,0,0,0,0,1,0,0,1
DW00100303,0,0,0,1,0,0,1,1,3
DW00100007,0,0,0,1,0,0,0,0,1
DW00100344,0,0,0,1,0,0,0,1,2
DW00100201,0,1,0,1,0,0,5,1,8
X50005L1S,0,0,0,0,0,0,0,0,0
GW0767L4,0,1,1,1,1,0,1,1,6
GW0746L3,0,0,0,1,1,0,0,1,3
GW0765L1,0,1,1,1,1,0,24,1,29
GW0765L2,0,1,1,1,1,0,12,1,17
GW0663G1,0,1,0,1,1,0,0,1,4
GW0662G1,0,0,0,1,1,0,0,1,3
GW0667L1,0,0,0,0,0,0,0,0,0
GW0662G2,0,0,0,0,0,0,0,0,0
GW0670L3,0,0,0,0,0,0,0,0,0
GW0670L4,0,0,0,0,0,0,0,0,0
Z52002L9MF,0,0,0,1,1,0,0,0,2
Z46001G2MF,0,0,0,1,1,0,2,0,4
Z49001L1MF,0,0,0,1,1,0,2,0,4
Z44003L1MF,0,0,0,1,1,0,1,0,3
Z52001L1MF,0,0,0,1,1,0,0,0,2
Z48002L1MF,0,0,0,1,1,0,0,0,2
Z44002L9MF,0,0,0,1,1,0,1,0,3
Z50004G9MF,0,0,0,1,1,0,2,0,4
Z45001L9MF,0,0,0,1,0,0,0,0,1
Z48003L6MF,0,0,0,1,1,0,1,0,3